jugador,pais,partidos,minutos_jugados,goles_de_campo,goles_de_campo_intentos,goles_de_campo_porcentaje,goles_de_campo_tres_puntos,goles_de_campo_tres_puntos_intentos,goles_de_campo_tres_puntos_porcentaje,goles_de_campo_dos_puntos,goles_de_campo_dos_puntos_intentos,goles_de_campo_dos_puntos_porcentaje,goles_de_campo_efectividad_porcentaje,tiros_libres,tiros_libres_intentos,tiros_libres_porcentaje,rebotes_ofensiva,rebotes_defensiva,rebotes_total,asistencias,robadas,bloqueos,pelotas_perdidas,faltas_personales,puntos
Aaron Cel,Polonia,8,157,21,52,0.404,8,24,0.333,13,28,0.464,0.481,1,2,0.5,6,21,27,7,4,0,9,13,51
Aaron Geramipoor,Irán,5,84,23,33,0.697,0,0,NA,23,33,0.697,0.697,6,10,0.6,9,21,30,4,3,1,8,12,52
Abudurexiti Abudushalamu,China,4,22,2,5,0.4,1,3,0.333,1,2,0.5,0.5,2,2,1,1,1,2,0,1,0,3,4,7
Adam Hrycaniuk,Polonia,8,164,20,37,0.541,0,0,NA,20,37,0.541,0.541,9,14,0.643,14,24,38,15,3,1,10,21,49
Adam Waczynski,Polonia,8,251,34,80,0.425,15,40,0.375,19,40,0.475,0.519,28,30,0.933,5,16,21,22,5,1,14,14,111
Agustin Caffaro,Argentina,6,16,3,5,0.6,0,0,NA,3,5,0.6,0.6,2,3,0.667,2,2,4,1,1,1,1,4,8
Ahmed Hamarsha,Jordania,5,101,7,18,0.389,4,13,0.308,3,5,0.6,0.5,1,2,0.5,3,10,13,4,2,1,1,9,19
Ahmed Obeid,Jordania,3,13,1,3,0.333,0,0,NA,1,3,0.333,0.333,0,0,NA,1,1,2,0,1,0,1,2,2
Ahmet Duverioglu,Jordania,4,122,26,43,0.605,0,0,NA,26,43,0.605,0.605,13,20,0.65,11,18,29,6,2,1,8,8,65
Ahmet Tuncer,Turquía,5,52,4,11,0.364,1,5,0.2,3,6,0.5,0.409,2,2,1,1,5,6,13,1,0,3,6,11
Ailun Guo,China,5,107,17,50,0.34,3,16,0.188,14,34,0.412,0.37,5,8,0.625,4,3,7,19,6,0,6,12,42
A.J. Slaughter,Polonia,8,238,39,98,0.398,13,40,0.325,26,58,0.448,0.464,15,17,0.882,7,15,22,38,7,1,16,12,106
Al-Farouq Aminu,Nigeria,5,110,14,31,0.452,2,6,0.333,12,25,0.48,0.484,11,15,0.733,5,28,33,18,7,5,10,7,41
Aleksa Popovic,Montenegro,4,27,2,6,0.333,0,2,0,2,4,0.5,0.333,1,2,0.5,0,1,1,2,0,0,1,3,5
Alessandro Gentile,Italia,4,76,8,25,0.32,3,4,0.75,5,21,0.238,0.38,11,18,0.611,3,8,11,7,1,0,6,6,30
Alex Franklin,Puerto Rico,5,74,5,13,0.385,1,3,0.333,4,10,0.4,0.423,0,0,NA,4,9,13,3,1,0,3,10,11
Alex Garcia,Brasil,5,112,17,40,0.425,4,12,0.333,13,28,0.464,0.475,12,15,0.8,2,12,14,12,8,0,9,11,50
Alex Pledger,Nueva Zelanda,5,24,3,8,0.375,0,0,NA,3,8,0.375,0.375,0,0,NA,2,5,7,2,0,0,0,3,6
Amath M'Baye,Francia,8,145,17,30,0.567,10,18,0.556,7,12,0.583,0.733,2,4,0.5,5,10,15,2,0,2,6,15,46
Amedeo Della Valle,Italia,5,53,10,26,0.385,5,17,0.294,5,9,0.556,0.481,6,6,1,1,5,6,6,3,0,5,3,31
Amedeo Tessitori,Italia,5,48,14,20,0.7,0,1,0,14,19,0.737,0.7,4,6,0.667,4,8,12,3,0,3,2,9,32
Amin Abu Hawwas,Jordania,4,23,5,9,0.556,1,3,0.333,4,6,0.667,0.611,2,2,1,1,1,2,0,1,1,2,2,13
Anderson Varejao,Brasil,5,112,21,37,0.568,0,1,0,21,36,0.583,0.568,8,9,0.889,3,32,35,9,3,0,2,8,50
Andray Blatche,Filipinas,5,165,30,75,0.4,9,32,0.281,21,43,0.488,0.46,10,16,0.625,8,34,42,17,12,3,22,18,79
Andreas Obst,Alemania,4,21,3,6,0.5,3,5,0.6,0,1,0,0.75,0,0,NA,0,2,2,3,0,0,2,3,9
Andrei Sopin,Rusia,4,25,4,7,0.571,1,4,0.25,3,3,1,0.643,0,0,NA,0,1,1,4,1,0,3,4,9
Andrew Albicy,Francia,8,155,13,30,0.433,9,18,0.5,4,12,0.333,0.583,3,4,0.75,1,9,10,21,10,0,8,17,38
Andrew Bogut,Australia,8,143,31,49,0.633,0,2,0,31,47,0.66,0.633,2,6,0.333,12,36,48,19,4,6,13,24,64
Andrew Nembhard,Canadá,5,49,5,12,0.417,2,6,0.333,3,6,0.5,0.5,2,2,1,0,2,2,12,1,0,4,6,14
Andrey Vorontsevich,Rusia,5,140,22,43,0.512,8,20,0.4,14,23,0.609,0.605,12,13,0.923,6,29,35,14,4,2,5,13,64
Andrey Zubkov,Rusia,5,114,18,42,0.429,2,12,0.167,16,30,0.533,0.452,9,11,0.818,5,16,21,12,3,6,10,14,47
Angel Rodriguez,Puerto Rico,5,85,9,31,0.29,3,13,0.231,6,18,0.333,0.339,12,14,0.857,5,9,14,12,5,0,13,14,33
Anthony Perez,Venezuela,2,17,0,5,0,0,3,0,0,2,0,0,1,2,0.5,1,1,2,0,0,0,1,3,1
Ariel Filloy,Italia,3,43,5,12,0.417,2,7,0.286,3,5,0.6,0.5,1,1,1,0,6,6,8,3,0,4,6,13
Arman Zangeneh,Irán,4,45,4,11,0.364,2,5,0.4,2,6,0.333,0.455,1,2,0.5,0,5,5,1,2,2,3,7,11
Arnas Butkevicius,Lituania,5,51,6,8,0.75,0,1,0,6,7,0.857,0.75,2,3,0.667,3,9,12,3,0,0,3,7,14
Aron Baynes,Australia,8,170,35,62,0.565,11,21,0.524,24,41,0.585,0.653,10,11,0.909,12,32,44,14,3,4,9,18,91
Augusto Lima,Brasil,2,8,0,1,0,0,0,NA,0,1,0,0,0,0,NA,0,1,1,0,0,0,1,4,0
Avi Koki Schafer,Japón,2,10,0,3,0,0,0,NA,0,3,0,0,0,0,NA,0,1,1,0,1,0,2,0,0
Awudu Abass,Italia,4,84,12,23,0.522,4,13,0.308,8,10,0.8,0.609,4,4,1,2,10,12,3,3,1,6,5,32
Axel Toupane,Francia,8,62,6,11,0.545,4,7,0.571,2,4,0.5,0.727,2,4,0.5,0,7,7,2,2,1,3,12,18
Babacar Toure,Senegal,4,63,14,25,0.56,3,4,0.75,11,21,0.524,0.62,1,1,1,8,1,9,1,2,0,3,7,32
Bali Coulibaly,Costa de Marfil,2,8,1,3,0.333,0,0,NA,1,3,0.333,0.333,2,2,1,2,0,2,0,0,0,0,0,4
Baru Adjehi,Costa de Marfil,3,31,4,6,0.667,0,0,NA,4,6,0.667,0.667,1,2,0.5,2,4,6,3,0,1,1,6,9
Behnam Yakhchali,Irán,5,177,21,41,0.512,12,25,0.48,9,16,0.563,0.659,6,7,0.857,3,11,14,15,9,1,7,4,60
Ben Uzoh,Nigeria,5,97,17,31,0.548,0,3,0,17,28,0.607,0.548,0,2,0,3,5,8,11,2,1,6,7,34
Blake Schilb,República Checa,6,103,16,28,0.571,11,17,0.647,5,11,0.455,0.768,1,2,0.5,0,8,8,14,4,1,3,2,44
Boban Marjanovic,Serbia,8,78,22,29,0.759,0,1,0,22,28,0.786,0.759,10,15,0.667,8,12,20,5,1,3,10,12,54
Bogdan Bogdanovic,Serbia,8,224,60,108,0.556,35,66,0.53,25,42,0.595,0.718,28,35,0.8,8,25,33,35,10,2,11,10,183
Bojan Dubljevic,Montenegro,5,128,14,34,0.412,8,22,0.364,6,12,0.5,0.529,14,18,0.778,12,23,35,13,7,0,15,14,50
Brady Heslip,Canadá,5,61,9,23,0.391,7,18,0.389,2,5,0.4,0.543,3,3,1,1,4,5,2,0,0,0,6,28
Brook Lopez,EE. UU.,7,66,6,27,0.222,3,19,0.158,3,8,0.375,0.278,3,5,0.6,3,10,13,2,0,5,3,4,18
Bruno Caboclo,Brasil,5,134,11,31,0.355,5,16,0.313,6,15,0.4,0.435,1,2,0.5,4,22,26,6,5,6,5,12,28
Bryan Pamba,Costa de Marfil,5,95,8,26,0.308,3,10,0.3,5,16,0.313,0.365,3,4,0.75,6,13,19,12,5,0,7,6,22
Cameron Gliddon,Australia,1,1,0,0,NA,0,0,NA,0,0,NA,NA,0,0,NA,0,0,0,0,0,0,0,0,0
Carlos Morais,Angola,5,156,25,59,0.424,8,21,0.381,17,38,0.447,0.492,5,8,0.625,3,9,12,12,4,1,13,9,63
Cedi Osman,Turquía,5,163,38,76,0.5,10,34,0.294,28,42,0.667,0.566,16,19,0.842,2,14,16,13,7,2,7,14,102
Chan Hee Park,Corea del Sur,5,86,11,18,0.611,0,3,0,11,15,0.733,0.611,4,10,0.4,2,8,10,18,7,1,11,5,26
Chimezie Metu,Nigeria,5,94,16,31,0.516,5,9,0.556,11,22,0.5,0.597,8,8,1,8,20,28,7,2,6,8,8,45
Chris Brady,Puerto Rico,3,16,0,3,0,0,1,0,0,2,0,0,2,2,1,1,3,4,0,2,0,0,5,2
Chris Goulding,Australia,8,142,18,49,0.367,12,37,0.324,6,12,0.5,0.49,10,11,0.909,0,9,9,5,3,0,7,20,58
Cj Perez,Filipinas,5,97,25,46,0.543,5,15,0.333,20,31,0.645,0.598,8,12,0.667,7,9,16,13,4,0,14,10,63
Conor Morgan,Canadá,4,44,8,17,0.471,5,9,0.556,3,8,0.375,0.618,4,4,1,4,5,9,1,2,2,8,9,25
Corey Webster,Nueva Zelanda,5,149,39,72,0.542,24,44,0.545,15,28,0.536,0.708,12,13,0.923,3,20,23,28,5,0,8,10,114
Cory Joseph,Canadá,5,132,29,63,0.46,8,18,0.444,21,45,0.467,0.524,9,10,0.9,4,13,17,24,7,0,9,13,75
Cristiano Felicio,Brasil,5,80,13,22,0.591,0,0,NA,13,22,0.591,0.591,5,6,0.833,16,12,28,7,2,1,6,6,31
Daesung Lee,Corea del Sur,3,47,9,25,0.36,8,18,0.444,1,7,0.143,0.52,4,5,0.8,2,4,6,4,4,0,6,10,30
Dagoberto Pena,República Dominicana,5,31,2,8,0.25,2,6,0.333,0,2,0,0.375,2,2,1,1,0,1,3,1,0,1,4,8
Daiki Tanaka,Japón,5,115,11,32,0.344,5,14,0.357,6,18,0.333,0.422,4,6,0.667,2,3,5,9,6,0,7,7,31
Damian Kulig,Polonia,8,159,22,50,0.44,4,20,0.2,18,30,0.6,0.48,20,26,0.769,12,25,37,8,6,9,9,16,68
Daniel Hackett,Italia,5,121,10,32,0.313,6,19,0.316,4,13,0.308,0.406,13,20,0.65,1,23,24,14,6,0,13,11,39
Daniel Theis,Alemania,5,89,17,39,0.436,1,9,0.111,16,30,0.533,0.449,3,4,0.75,9,21,30,1,6,3,6,16,38
Danilo Barthel,Alemania,5,87,11,22,0.5,1,7,0.143,10,15,0.667,0.523,5,8,0.625,5,15,20,2,3,2,2,5,28
Danilo Gallinari,Italia,5,149,26,49,0.531,12,24,0.5,14,25,0.56,0.653,22,28,0.786,6,22,28,14,5,2,5,8,86
Dar Tucker,Jordania,5,165,32,78,0.41,7,28,0.25,25,50,0.5,0.455,34,39,0.872,2,22,24,6,6,1,15,7,105
David Barlow,Australia,2,0,0,0,NA,0,0,NA,0,0,NA,NA,0,0,NA,0,0,0,0,0,0,0,0,0
David Huertas,Puerto Rico,5,132,27,57,0.474,10,25,0.4,17,32,0.531,0.561,7,8,0.875,1,8,9,10,1,1,8,10,71
Dennis Schroder,Alemania,5,164,29,70,0.414,10,21,0.476,19,49,0.388,0.486,30,37,0.811,4,19,23,47,7,1,17,7,98
Deon Thompson,Costa de Marfil,5,154,25,53,0.472,8,17,0.471,17,36,0.472,0.547,8,10,0.8,10,22,32,8,5,3,11,8,66
Derek Needham,Montenegro,5,129,16,43,0.372,11,35,0.314,5,8,0.625,0.5,2,3,0.667,0,3,3,25,7,1,12,14,45
Derrick White,EE. UU.,8,124,19,41,0.463,2,12,0.167,17,29,0.586,0.488,7,9,0.778,2,8,10,20,10,0,11,14,47
Devon Collier,Puerto Rico,5,111,13,27,0.481,0,1,0,13,26,0.5,0.481,3,4,0.75,7,13,20,2,2,1,3,12,29
Didi,Brasil,5,46,3,13,0.231,2,6,0.333,1,7,0.143,0.308,3,4,0.75,1,8,9,3,4,1,0,5,11
Dino Radoncic,Montenegro,5,83,9,16,0.563,1,4,0.25,8,12,0.667,0.594,1,4,0.25,8,14,22,3,2,5,5,9,20
Divaldo Mbunga,Angola,3,20,1,4,0.25,0,1,0,1,3,0.333,0.25,0,0,NA,0,1,1,2,0,1,1,2,2
Djibril Thiam,Senegal,2,26,3,13,0.231,0,5,0,3,8,0.375,0.231,1,2,0.5,2,3,5,2,0,0,5,2,7
Dogus Balbay,Turquía,5,86,3,10,0.3,1,5,0.2,2,5,0.4,0.35,0,2,0,8,9,17,21,5,2,2,9,7
Domantas Sabonis,Lituania,4,95,15,31,0.484,0,1,0,15,30,0.5,0.484,12,17,0.706,13,12,25,15,1,3,4,12,42
Dominik Olejniczak,Polonia,5,14,4,8,0.5,0,0,NA,4,8,0.5,0.5,0,0,NA,2,5,7,1,0,0,1,2,8
Donovan Mitchell,EE. UU.,8,217,41,88,0.466,17,42,0.405,24,46,0.522,0.563,6,8,0.75,7,27,34,40,9,3,8,16,105
Dwight Lewis,Venezuela,5,87,17,33,0.515,4,9,0.444,13,24,0.542,0.576,2,2,1,2,5,7,5,2,1,3,7,40
Edgaras Ulanovas,Lituania,5,111,12,26,0.462,0,7,0,12,19,0.632,0.462,12,14,0.857,5,13,18,11,3,0,2,8,36
Eduardo Mingas,Angola,2,21,2,5,0.4,0,0,NA,2,5,0.4,0.4,0,0,NA,2,3,5,1,1,0,2,3,4
Ege Arar,Turquía,2,11,1,3,0.333,0,0,NA,1,3,0.333,0.333,0,2,0,0,2,2,1,0,1,0,5,2
Ekpe Udoh,Nigeria,5,95,14,23,0.609,0,0,NA,14,23,0.609,0.609,5,7,0.714,7,11,18,4,4,5,2,7,33
Eloy Vargas,República Dominicana,5,101,21,38,0.553,0,2,0,21,36,0.583,0.553,13,15,0.867,9,18,27,3,1,3,4,15,55
Ersan Ilyasova,Turquía,3,98,16,44,0.364,6,18,0.333,10,26,0.385,0.432,10,11,0.909,5,23,28,6,5,3,5,10,48
Ethan Rusbatch,Nueva Zelanda,5,51,6,17,0.353,5,14,0.357,1,3,0.333,0.5,1,2,0.5,1,4,5,0,1,0,3,7,18
Eulis Baez,República Dominicana,5,121,12,37,0.324,5,21,0.238,7,16,0.438,0.392,3,4,0.75,6,16,22,8,6,2,3,9,32
Evan Fournier,Francia,8,225,58,138,0.42,16,39,0.41,42,99,0.424,0.478,26,36,0.722,2,28,30,24,7,1,15,20,158
Evegeny Valiev,Rusia,4,30,4,7,0.571,0,0,NA,4,7,0.571,0.571,2,4,0.5,4,2,6,2,1,1,0,3,10
Evgeny Baburin,Rusia,5,52,4,9,0.444,4,9,0.444,0,0,NA,0.667,1,2,0.5,6,3,9,7,3,0,2,14,13
Facu Campazzo,Argentina,8,233,33,79,0.418,18,46,0.391,15,33,0.455,0.532,22,28,0.786,6,28,34,62,16,1,21,15,106
Fadi Ibrahim,Jordania,5,120,13,35,0.371,6,14,0.429,7,21,0.333,0.457,4,6,0.667,0,12,12,17,3,1,14,8,36
Finn Delaney,Nueva Zelanda,5,71,7,14,0.5,0,3,0,7,11,0.636,0.5,2,2,1,6,9,15,0,1,0,5,12,16
Frank Ntilikina,Francia,8,156,24,55,0.436,8,24,0.333,16,31,0.516,0.509,8,9,0.889,4,17,21,20,8,1,11,15,64
Frejus Zerbo,Costa de Marfil,5,53,5,11,0.455,0,0,NA,5,11,0.455,0.455,0,1,0,3,10,13,4,3,0,4,13,10
Furkan Korkmaz,Turquía,4,106,18,40,0.45,7,18,0.389,11,22,0.5,0.538,4,5,0.8,4,10,14,7,6,1,6,6,47
Gabe Norwood,Filipinas,5,88,2,13,0.154,2,10,0.2,0,3,0,0.231,0,0,NA,3,6,9,6,4,0,2,11,6
Gabe Vincent,Nigeria,5,93,20,40,0.5,12,30,0.4,8,10,0.8,0.65,5,7,0.714,1,5,6,3,8,0,4,14,57
Gabriel Deck,Argentina,8,196,42,75,0.56,6,16,0.375,36,59,0.61,0.6,21,29,0.724,9,16,25,7,9,1,7,14,111
Gary Browne,Puerto Rico,5,120,19,54,0.352,2,13,0.154,17,41,0.415,0.37,5,5,1,4,14,18,23,5,0,8,9,45
Gelvis Solano,República Dominicana,5,122,12,39,0.308,3,14,0.214,9,25,0.36,0.346,2,11,0.182,1,12,13,33,6,0,14,13,29
Georgios Papagiannis,Grecia,4,45,9,17,0.529,0,0,NA,9,17,0.529,0.529,1,1,1,3,10,13,1,2,4,1,7,19
Gerson Domingos,Angola,4,102,11,34,0.324,5,16,0.313,6,18,0.333,0.397,8,9,0.889,3,7,10,10,1,0,13,6,35
Gerson Lukeny Goncalves,Angola,5,70,6,22,0.273,1,8,0.125,5,14,0.357,0.295,3,4,0.75,1,4,5,8,2,1,6,6,16
Gian Clavell,Puerto Rico,5,93,11,41,0.268,5,22,0.227,6,19,0.316,0.329,9,12,0.75,5,11,16,7,3,0,3,4,36
Giannis Antetokounmpo,Grecia,5,125,24,46,0.522,2,9,0.222,22,37,0.595,0.543,24,34,0.706,5,39,44,12,12,3,13,18,74
Giannoulis Larentzakis,Grecia,4,38,5,9,0.556,2,6,0.333,3,3,1,0.667,6,7,0.857,0,2,2,5,3,1,4,6,18
Giorgos Printezis,Grecia,5,109,21,44,0.477,7,14,0.5,14,30,0.467,0.557,12,17,0.706,1,10,11,10,2,0,3,4,61
Gregory Vargas,Venezuela,5,103,10,33,0.303,1,9,0.111,9,24,0.375,0.318,10,12,0.833,4,9,13,12,3,0,13,12,31
Grigory Motovilov,Rusia,5,73,9,25,0.36,2,10,0.2,7,15,0.467,0.4,3,7,0.429,0,5,5,6,2,0,10,8,23
Willy Hernangomez,España,8,103,22,42,0.524,0,2,0,22,40,0.55,0.524,12,19,0.632,12,19,31,10,4,6,6,13,56
Guna Ra,Corea del Sur,5,181,45,91,0.495,3,7,0.429,42,84,0.5,0.511,22,33,0.667,26,38,64,9,7,6,12,9,115
Guy Edi,Costa de Marfil,5,126,11,38,0.289,5,18,0.278,6,20,0.3,0.355,6,8,0.75,4,12,16,9,1,0,9,6,33
Hamady N'Diaye,Senegal,4,44,3,4,0.75,0,0,NA,3,4,0.75,0.75,1,2,0.5,2,4,6,1,1,4,1,5,7
Hamed Haddadi,Irán,5,151,28,59,0.475,4,7,0.571,24,52,0.462,0.508,13,21,0.619,12,42,54,22,3,6,22,15,73
Hamed Hosseinzadeh,Irán,2,12,0,2,0,0,1,0,0,1,0,0,0,0,NA,0,1,1,2,0,0,1,0,0
Harrison Barnes,EE. UU.,8,212,30,63,0.476,9,27,0.333,21,36,0.583,0.548,24,27,0.889,12,25,37,12,10,1,9,13,93
Heejong Yang,Corea del Sur,4,55,2,10,0.2,2,9,0.222,0,1,0,0.3,2,2,1,2,9,11,6,3,1,3,10,8
Heissler Guillent,Venezuela,5,144,26,61,0.426,12,28,0.429,14,33,0.424,0.525,1,3,0.333,3,7,10,31,5,0,8,7,65
Hoon Heo,Corea del Sur,5,44,7,20,0.35,4,9,0.444,3,11,0.273,0.45,3,4,0.75,1,1,2,4,2,0,2,2,21
Hyogeun Jeong,Corea del Sur,4,59,4,18,0.222,2,10,0.2,2,8,0.25,0.278,2,2,1,1,8,9,1,1,1,1,4,12
Ibrahima Fall Faye,Senegal,3,83,10,30,0.333,3,13,0.231,7,17,0.412,0.383,4,8,0.5,8,12,20,5,2,5,6,11,27
Ike Diogu,Nigeria,5,86,12,36,0.333,3,15,0.2,9,21,0.429,0.375,5,7,0.714,7,22,29,4,1,2,7,8,32
Ike Iroegbu,Nigeria,5,106,14,38,0.368,4,15,0.267,10,23,0.435,0.421,9,11,0.818,0,11,11,14,4,0,10,11,41
Ioannis Papapetrou,Grecia,5,113,14,33,0.424,6,18,0.333,8,15,0.533,0.515,3,5,0.6,5,11,16,2,4,1,3,4,37
Isaac Fotu,Nueva Zelanda,5,123,34,51,0.667,2,8,0.25,32,43,0.744,0.686,22,30,0.733,7,23,30,8,1,0,8,12,92
Isaiah Pineiro,Puerto Rico,5,81,11,26,0.423,1,6,0.167,10,20,0.5,0.442,7,8,0.875,4,10,14,3,5,0,2,10,30
Ismet Akpinar,Alemania,5,96,8,26,0.308,5,15,0.333,3,11,0.273,0.404,0,0,NA,4,7,11,2,1,0,2,13,21
Jakub Sirina,República Checa,6,33,2,7,0.286,1,4,0.25,1,3,0.333,0.357,2,4,0.5,0,0,0,9,0,0,3,6,7
James Birsen,Turquía,5,89,12,24,0.5,1,8,0.125,11,16,0.688,0.521,6,6,1,8,16,24,1,1,0,6,4,31
Japeth Aguilar,Filipinas,5,105,11,30,0.367,1,4,0.25,10,26,0.385,0.383,1,2,0.5,7,8,15,5,0,1,3,11,24
Jaromir Bohacik,República Checa,8,243,45,101,0.446,20,47,0.426,25,54,0.463,0.545,12,15,0.8,8,24,32,19,2,1,12,25,122
Javier Beiran,España,4,17,2,5,0.4,0,3,0,2,2,1,0.4,0,0,NA,3,4,7,0,1,0,0,0,4
Javier Mojica,Puerto Rico,5,39,4,18,0.222,0,4,0,4,14,0.286,0.222,2,2,1,3,6,9,1,4,1,0,4,10
Jaylen Brown,EE. UU.,8,160,26,58,0.448,6,17,0.353,20,41,0.488,0.5,5,11,0.455,11,23,34,11,5,2,4,14,63
Jayson Tatum,EE. UU.,2,49,7,22,0.318,2,8,0.25,5,14,0.357,0.364,5,6,0.833,3,12,15,5,2,3,4,4,21
Jeff Brooks,Italia,5,85,9,16,0.563,2,6,0.333,7,10,0.7,0.625,2,3,0.667,9,12,21,5,8,6,2,12,22
Jhornan Jose Zamora,Venezuela,5,101,14,44,0.318,9,30,0.3,5,14,0.357,0.42,2,3,0.667,1,5,6,5,2,0,2,8,39
Jianlian Yi,China,5,138,31,60,0.517,5,14,0.357,26,46,0.565,0.558,22,36,0.611,9,30,39,6,5,3,13,12,89
Quino Colom,España,5,27,3,6,0.5,1,3,0.333,2,3,0.667,0.583,0,0,NA,1,2,3,6,1,0,2,3,7
Jock Landale,Australia,8,148,20,39,0.513,7,15,0.467,13,24,0.542,0.603,3,6,0.5,4,23,27,6,2,2,13,14,50
Joe Harris,EE. UU.,8,170,23,45,0.511,13,26,0.5,10,19,0.526,0.656,5,6,0.833,9,22,31,10,4,0,8,21,64
Joe Ingles,Australia,8,271,30,68,0.441,10,38,0.263,20,30,0.667,0.515,14,16,0.875,1,48,49,45,13,3,24,18,84
Johannes Thiemann,Alemania,1,8,2,3,0.667,0,0,NA,2,3,0.667,0.667,1,1,1,1,2,3,0,0,0,2,1,5
Johannes Voigtmann,Alemania,5,101,21,33,0.636,10,18,0.556,11,15,0.733,0.788,5,7,0.714,8,19,27,14,4,3,11,13,57
Johnkyu Kim,Corea del Sur,3,25,2,11,0.182,0,0,NA,2,11,0.182,0.182,0,0,NA,2,3,5,1,1,0,3,5,4
Joji Takeuchi,Japón,5,92,4,14,0.286,1,4,0.25,3,10,0.3,0.321,7,10,0.7,4,8,12,4,1,0,5,4,16
Jonas Maciulis,Lituania,5,89,7,22,0.318,5,13,0.385,2,9,0.222,0.432,5,6,0.833,4,14,18,6,5,0,2,13,24
Jonas Valanciunas,Lituania,5,113,27,42,0.643,0,1,0,27,41,0.659,0.643,16,22,0.727,13,31,44,5,5,8,5,13,70
Jordan Dasuqi,Jordania,5,54,2,6,0.333,1,5,0.2,1,1,1,0.417,0,0,NA,0,2,2,1,1,0,1,4,5
Jordan Ngatai,Nueva Zelanda,3,23,1,2,0.5,1,1,1,0,1,0,0.75,0,0,NA,0,2,2,0,0,0,1,3,3
Jordan Nwora,Nigeria,2,51,8,24,0.333,3,11,0.273,5,13,0.385,0.396,3,4,0.75,0,7,7,4,6,0,4,4,22
Jorge Diaz,Puerto Rico,5,68,9,21,0.429,2,4,0.5,7,17,0.412,0.476,1,2,0.5,3,11,14,2,1,3,5,11,21
Jose Antonio,Angola,5,92,8,21,0.381,5,13,0.385,3,8,0.375,0.5,6,8,0.75,2,5,7,3,5,1,4,12,27
Jose Vargas,Venezuela,5,81,6,22,0.273,3,12,0.25,3,10,0.3,0.341,0,2,0,3,7,10,4,5,1,6,13,15
Josh Okogie,Nigeria,5,120,18,42,0.429,8,19,0.421,10,23,0.435,0.524,19,21,0.905,2,16,18,22,12,6,10,8,63
Juan Hernangomez,España,8,185,30,52,0.577,11,25,0.44,19,27,0.704,0.683,13,19,0.684,13,30,43,5,8,3,7,23,84
Juan Jose Garcia,República Dominicana,4,21,1,6,0.167,1,5,0.2,0,1,0,0.25,0,2,0,1,3,4,1,1,1,2,3,3
Juan Miguel Suero,República Dominicana,4,19,0,1,0,0,0,NA,0,1,0,0,2,2,1,1,2,3,0,0,0,1,2,2
June Mar Fajardo,Filipinas,5,86,11,23,0.478,0,0,NA,11,23,0.478,0.478,13,16,0.813,10,15,25,3,4,2,6,8,35
Junfei Ren,China,3,24,1,3,0.333,0,0,NA,1,3,0.333,0.333,0,0,NA,0,3,3,1,0,0,4,3,2
Junghyun Lee,Corea del Sur,4,104,12,35,0.343,9,28,0.321,3,7,0.429,0.471,7,10,0.7,1,15,16,16,1,1,11,13,40
Junyong Choi,Corea del Sur,5,83,4,15,0.267,3,11,0.273,1,4,0.25,0.367,3,6,0.5,4,8,12,6,0,4,5,10,14
Kamil Laczynski,Polonia,4,11,0,5,0,0,4,0,0,1,0,0,0,0,NA,1,0,1,2,1,0,1,4,0
Karol Gruszecki,Polonia,7,41,7,16,0.438,2,10,0.2,5,6,0.833,0.5,2,4,0.5,1,8,9,1,3,0,5,1,18
Kaza Kajami-Keane,Canadá,4,25,4,11,0.364,2,5,0.4,2,6,0.333,0.455,5,8,0.625,1,2,3,4,2,0,3,2,15
Kelanbaike Makan,China,1,0,0,0,NA,0,0,NA,0,0,NA,NA,0,0,NA,0,0,0,0,0,0,0,0,0
Kemba Walker,EE. UU.,7,178,36,74,0.486,15,39,0.385,21,35,0.6,0.588,14,20,0.7,5,16,21,38,6,2,12,16,101
Kevin Pangos,Canadá,5,127,16,46,0.348,7,23,0.304,9,23,0.391,0.424,2,3,0.667,2,7,9,26,6,0,5,11,41
Khem Birch,Canadá,5,125,22,38,0.579,0,4,0,22,34,0.647,0.579,14,20,0.7,20,15,35,8,10,7,7,9,58
Khris Middleton,EE. UU.,8,158,28,64,0.438,10,28,0.357,18,36,0.5,0.516,13,14,0.929,10,29,39,19,5,0,8,17,79
Kiefer Ravena,Filipinas,5,89,6,31,0.194,4,19,0.211,2,12,0.167,0.258,8,11,0.727,2,5,7,8,3,0,6,10,24
Kostas Papanikolaou,Grecia,5,116,5,25,0.2,2,14,0.143,3,11,0.273,0.24,7,7,1,8,12,20,7,3,5,0,12,19
Kostas Sloukas,Grecia,5,127,17,42,0.405,5,18,0.278,12,24,0.5,0.464,10,13,0.769,1,11,12,23,2,0,4,9,49
Kosuke Takeuchi,Japón,3,31,0,3,0,0,0,NA,0,3,0,0,5,6,0.833,4,4,8,1,2,0,0,3,5
Kyle Wiltjer,Canadá,5,117,28,57,0.491,15,36,0.417,13,21,0.619,0.623,11,13,0.846,5,10,15,5,3,0,5,6,82
Lamine Sambe,Senegal,5,122,13,44,0.295,7,27,0.259,6,17,0.353,0.375,0,0,NA,1,3,4,11,3,0,8,12,33
Leandro Barbosa,Brasil,5,113,24,56,0.429,4,11,0.364,20,45,0.444,0.464,16,19,0.842,0,8,8,11,3,1,8,10,68
Leandro Jacques Conceicao,Angola,4,72,5,16,0.313,2,9,0.222,3,7,0.429,0.375,0,0,NA,0,4,4,5,1,1,3,9,12
Leonel Paulo,Angola,5,99,15,23,0.652,1,3,0.333,14,20,0.7,0.674,11,16,0.688,3,12,15,10,3,2,5,15,42
Louis Cyrille Jean Benoit A Sie,Costa de Marfil,2,9,0,1,0,0,1,0,0,0,NA,0,0,0,NA,1,0,1,0,0,0,0,1,0
Louis Labeyrie,Francia,5,47,6,8,0.75,2,4,0.5,4,4,1,0.875,0,0,NA,3,10,13,1,0,1,3,6,14
Luca Vildoza,Argentina,8,132,13,34,0.382,8,25,0.32,5,9,0.556,0.5,12,13,0.923,0,12,12,17,12,1,11,17,46
Luca Vitali,Italia,4,34,1,5,0.2,0,2,0,1,3,0.333,0.2,0,0,NA,0,0,0,6,0,1,5,5,2
Lucio Redivo,Argentina,4,18,2,11,0.182,1,8,0.125,1,3,0.333,0.227,2,2,1,0,1,1,3,1,0,2,0,7
Luigi Datome,Italia,4,90,16,27,0.593,6,12,0.5,10,15,0.667,0.704,4,5,0.8,1,10,11,8,3,3,5,11,42
Luis Bethelmy,Venezuela,4,38,6,12,0.5,4,8,0.5,2,4,0.5,0.667,3,6,0.5,3,9,12,1,0,0,1,4,19
Luis Montero,República Dominicana,5,96,10,29,0.345,5,16,0.313,5,13,0.385,0.431,3,6,0.5,4,10,14,3,7,3,4,12,28
Luis Scola,Argentina,8,236,46,106,0.434,11,29,0.379,35,77,0.455,0.486,40,46,0.87,14,51,65,14,6,3,15,24,143
Lukas Lekavicius,Lituania,5,88,24,37,0.649,3,9,0.333,21,28,0.75,0.689,14,15,0.933,0,8,8,9,5,0,6,9,65
Lukas Palyza,República Checa,4,17,2,6,0.333,2,6,0.333,0,0,NA,0.5,0,0,NA,2,4,6,3,1,0,1,3,6
Lukasz Koszarek,Polonia,8,110,7,24,0.292,6,16,0.375,1,8,0.125,0.417,0,0,NA,1,5,6,20,3,0,8,10,20
Mahmoud Abdeen,Jordania,5,76,11,22,0.5,5,13,0.385,6,9,0.667,0.614,0,0,NA,1,5,6,9,3,0,9,10,27
Makhtar Gueye,Senegal,3,23,5,13,0.385,4,9,0.444,1,4,0.25,0.538,0,0,NA,1,1,2,0,0,0,0,3,14
Makoto Hiejima,Japón,5,90,9,28,0.321,2,10,0.2,7,18,0.389,0.357,2,4,0.5,1,5,6,6,3,0,11,11,22
Makram Ben Romdhane,Túnez,5,141,25,49,0.51,6,15,0.4,19,34,0.559,0.571,9,19,0.474,17,19,36,19,9,2,8,16,65
Mantas Kalnietis,Lituania,5,117,21,41,0.512,7,19,0.368,14,22,0.636,0.598,1,2,0.5,1,10,11,27,3,0,7,7,50
Maodo Lo,Alemania,5,106,10,23,0.435,4,12,0.333,6,11,0.545,0.522,6,9,0.667,1,13,14,16,4,0,1,9,30
Marc Gasol,España,8,228,37,87,0.425,7,31,0.226,30,56,0.536,0.466,34,45,0.756,3,41,44,33,9,9,14,15,115
Marcelo Huertas,Brasil,5,92,16,38,0.421,3,9,0.333,13,29,0.448,0.461,3,3,1,2,8,10,24,2,0,5,7,38
Marco Belinelli,Italia,5,145,24,60,0.4,9,27,0.333,15,33,0.455,0.475,18,25,0.72,3,17,20,16,6,0,8,8,75
Marcos Delia,Argentina,8,182,25,41,0.61,0,0,NA,25,41,0.61,0.61,6,16,0.375,11,26,37,4,1,9,6,18,56
Marcus Smart,EE. UU.,5,89,10,21,0.476,3,10,0.3,7,11,0.636,0.548,9,15,0.6,2,5,7,6,4,1,3,9,32
Marius Grigonis,Lituania,5,99,19,42,0.452,4,12,0.333,15,30,0.5,0.5,9,9,1,1,8,9,6,6,0,8,11,51
Mark Barroca,Filipinas,4,45,6,13,0.462,1,5,0.2,5,8,0.625,0.5,2,2,1,2,2,4,1,1,0,4,8,15
Marko Guduric,Serbia,7,105,12,29,0.414,7,20,0.35,5,9,0.556,0.534,8,10,0.8,2,6,8,8,5,1,7,6,39
Marko Simonovic,Serbia,8,106,10,21,0.476,4,11,0.364,6,10,0.6,0.571,0,0,NA,3,10,13,2,3,1,4,11,24
Marko Todorovic,Montenegro,5,54,4,10,0.4,0,1,0,4,9,0.444,0.4,5,7,0.714,2,5,7,2,6,3,3,11,13
Marquinhos Vieira,Brasil,5,96,19,37,0.514,8,21,0.381,11,16,0.688,0.622,5,6,0.833,2,8,10,2,5,0,4,7,51
Martin Kriz,República Checa,8,89,10,27,0.37,0,5,0,10,22,0.455,0.37,0,0,NA,10,6,16,5,3,0,4,6,20
Martin Peterka,República Checa,8,91,18,31,0.581,9,15,0.6,9,16,0.563,0.726,2,2,1,7,10,17,7,2,1,5,2,47
Mason Plumlee,EE. UU.,6,47,3,9,0.333,0,0,NA,3,9,0.333,0.333,2,3,0.667,5,11,16,2,0,1,5,1,8
Mateusz Ponitka,Polonia,8,229,33,66,0.5,7,17,0.412,26,49,0.531,0.553,35,47,0.745,7,47,54,13,11,7,19,19,108
Mathias Lessort,Francia,6,72,8,17,0.471,0,0,NA,8,17,0.471,0.471,7,13,0.538,6,7,13,2,0,3,2,10,23
Matthew Dellavedova,Australia,8,245,23,69,0.333,14,39,0.359,9,30,0.3,0.435,11,15,0.733,10,25,35,50,5,0,20,17,71
Maurice Ndour,Senegal,5,136,20,53,0.377,1,10,0.1,19,43,0.442,0.387,10,12,0.833,5,16,21,7,10,3,13,13,51
Maxi Kleber,Alemania,5,116,21,41,0.512,5,18,0.278,16,23,0.696,0.573,9,9,1,6,9,15,3,5,9,6,6,56
Maximo Fjellerup,Argentina,7,59,7,11,0.636,1,2,0.5,6,9,0.667,0.682,1,4,0.25,1,14,15,3,5,1,1,9,16
Melih Mahmutoglu,Turquía,5,156,37,64,0.578,15,31,0.484,22,33,0.667,0.695,4,5,0.8,4,4,8,5,4,0,4,4,93
Melvin Ejim,Canadá,5,122,14,30,0.467,4,14,0.286,10,16,0.625,0.533,10,11,0.909,6,21,27,10,10,2,8,14,42
Michael Carrera,Venezuela,5,82,15,28,0.536,0,3,0,15,25,0.6,0.536,20,26,0.769,12,13,25,5,4,3,7,14,50
Michael Eric,Nigeria,4,51,15,19,0.789,0,0,NA,15,19,0.789,0.789,4,9,0.444,7,8,15,2,5,4,4,8,34
Michael Roll,Túnez,5,164,29,63,0.46,8,24,0.333,21,39,0.538,0.524,5,6,0.833,2,9,11,19,5,0,7,12,71
Michael Rostampour,Irán,5,83,6,16,0.375,3,10,0.3,3,6,0.5,0.469,5,8,0.625,3,10,13,2,6,0,2,10,20
Michal Sokolowski,Polonia,8,142,21,35,0.6,5,11,0.455,16,24,0.667,0.671,13,14,0.929,11,11,22,6,5,4,5,22,60
Miguel Ruiz,Venezuela,5,116,10,19,0.526,0,0,NA,10,19,0.526,0.526,1,1,1,15,23,38,4,7,0,4,17,21
Mikhail Kulagin,Rusia,5,105,15,47,0.319,11,30,0.367,4,17,0.235,0.436,12,12,1,0,7,7,8,3,0,10,11,53
Milko Bjelica,Montenegro,5,84,17,37,0.459,3,13,0.231,14,24,0.583,0.5,2,2,1,5,10,15,1,4,3,2,10,39
Mindaugas Kuzminskas,Lituania,5,83,14,31,0.452,3,11,0.273,11,20,0.55,0.5,4,7,0.571,8,6,14,1,3,1,9,8,35
Miroslav Raduljica,Serbia,7,67,11,24,0.458,0,0,NA,11,24,0.458,0.458,21,23,0.913,3,12,15,11,5,2,10,15,43
Mitchell Creek,Australia,8,92,7,15,0.467,0,2,0,7,13,0.538,0.467,8,14,0.571,8,13,21,4,2,1,2,13,22
Mohamed Abassi,Túnez,1,10,0,1,0,0,0,NA,0,1,0,0,1,2,0.5,0,1,1,1,0,0,0,3,1
Mohamed Deba Kone,Costa de Marfil,4,74,12,32,0.375,0,3,0,12,29,0.414,0.375,3,5,0.6,9,7,16,4,3,0,2,6,27
Mohammad Hassanzadeh,Irán,4,47,7,13,0.538,0,1,0,7,12,0.583,0.538,3,7,0.429,4,6,10,3,1,0,1,7,17
Mohammad Jamshidi,Irán,5,136,18,45,0.4,2,11,0.182,16,34,0.471,0.422,10,12,0.833,2,13,15,18,1,1,7,9,48
Mohammad Shaher,Jordania,4,45,5,17,0.294,0,0,NA,5,17,0.294,0.294,4,5,0.8,5,4,9,3,4,1,6,8,14
Mokhtar Ghayaza,Túnez,2,17,3,5,0.6,0,0,NA,3,5,0.6,0.6,1,2,0.5,0,2,2,1,0,0,1,2,7
Momar Ndoye,Senegal,5,35,0,4,0,0,0,NA,0,4,0,0,1,2,0.5,3,3,6,1,2,0,0,2,1
Mouhamed Hadidane,Túnez,5,76,14,27,0.519,6,11,0.545,8,16,0.5,0.63,2,4,0.5,2,11,13,3,0,1,3,6,36
Mouhammad Faye,Senegal,5,144,16,49,0.327,8,28,0.286,8,21,0.381,0.408,9,13,0.692,5,12,17,10,7,4,8,11,49
Mourad El Mabrouk,Túnez,5,144,13,40,0.325,6,25,0.24,7,15,0.467,0.4,4,5,0.8,4,6,10,12,1,1,4,5,36
Mousa AL Awadi,Jordania,5,99,11,26,0.423,6,15,0.4,5,11,0.455,0.538,0,0,NA,2,6,8,6,3,0,7,7,28
Myles Turner,EE. UU.,8,154,25,53,0.472,3,10,0.3,22,43,0.512,0.5,8,13,0.615,13,41,54,0,5,14,9,18,61
Nando De Colo,Francia,8,189,42,77,0.545,13,31,0.419,29,46,0.63,0.63,35,39,0.897,3,10,13,27,7,0,18,18,132
Nathan Sobey,Australia,2,5,1,1,1,0,0,NA,1,1,1,1,0,0,NA,0,0,0,0,0,0,0,1,2
Nemanja Bjelica,Serbia,7,150,24,56,0.429,12,28,0.429,12,28,0.429,0.536,15,18,0.833,12,21,33,19,6,4,9,13,75
Nemanja Radovic,Montenegro,2,16,2,5,0.4,0,0,NA,2,5,0.4,0.4,0,0,NA,3,2,5,1,0,1,0,5,4
Nestor Colmenares,Venezuela,5,130,19,47,0.404,2,8,0.25,17,39,0.436,0.426,6,9,0.667,15,14,29,10,7,1,6,16,46
Nicholas Kay,Australia,8,162,26,48,0.542,1,6,0.167,25,42,0.595,0.552,10,10,1,21,19,40,8,0,0,5,6,63
Nick Calathes,Grecia,5,143,27,55,0.491,10,24,0.417,17,31,0.548,0.582,3,7,0.429,3,19,22,27,8,0,13,13,67
Nick Fazekas,Japón,5,138,28,58,0.483,9,16,0.563,19,42,0.452,0.56,7,11,0.636,11,26,37,6,5,1,9,8,72
Nicolas Batum,Francia,7,209,18,45,0.4,8,30,0.267,10,15,0.667,0.489,7,10,0.7,3,22,25,17,5,8,5,11,51
Nicolas Brussino,Argentina,8,120,16,29,0.552,7,17,0.412,9,12,0.75,0.672,1,2,0.5,6,15,21,9,2,1,5,12,40
Nicolas Laprovittola,Argentina,8,179,23,72,0.319,15,49,0.306,8,23,0.348,0.424,19,23,0.826,3,15,18,29,12,0,14,16,80
Niels Giffey,Alemania,5,21,1,5,0.2,0,1,0,1,4,0.25,0.2,0,0,NA,1,0,1,1,0,0,3,3,2
Nikita Kurbanov,Rusia,5,138,15,32,0.469,3,9,0.333,12,23,0.522,0.516,15,23,0.652,5,26,31,18,2,1,9,17,48
Nikola Ivanovic,Montenegro,4,92,17,36,0.472,6,19,0.316,11,17,0.647,0.556,7,8,0.875,1,6,7,15,5,1,9,12,47
Nikola Jokic,Serbia,8,181,34,50,0.68,4,10,0.4,30,40,0.75,0.72,20,25,0.8,13,47,60,38,2,4,23,18,92
Nikola Milutinov,Serbia,8,115,21,27,0.778,0,0,NA,21,27,0.778,0.778,14,20,0.7,5,13,18,6,1,1,2,9,56
Nikola Vucevic,Montenegro,5,119,30,63,0.476,4,10,0.4,26,53,0.491,0.508,9,12,0.75,3,29,32,6,4,3,8,6,73
Nizar Knioua,Túnez,4,42,3,7,0.429,2,5,0.4,1,2,0.5,0.571,0,0,NA,0,1,1,2,1,0,5,4,8
Noe-Charles Abouo,Costa de Marfil,5,133,25,56,0.446,8,21,0.381,17,35,0.486,0.518,9,11,0.818,6,9,15,7,5,0,8,7,67
Olek Balcerowski,Polonia,8,108,7,18,0.389,1,11,0.091,6,7,0.857,0.417,5,13,0.385,3,12,15,4,2,0,4,9,20
Olimpio Cipriano,Angola,3,24,2,13,0.154,0,8,0,2,5,0.4,0.154,0,1,0,0,0,0,1,1,0,2,1,4
Omar Abada,Túnez,5,158,16,38,0.421,4,15,0.267,12,23,0.522,0.474,17,20,0.85,2,12,14,22,13,0,8,8,53
Omar Mouhli,Túnez,1,15,2,6,0.333,1,4,0.25,1,2,0.5,0.417,1,2,0.5,0,0,0,1,1,0,1,0,6
Ondrej Balvin,República Checa,8,211,29,51,0.569,1,2,0.5,28,49,0.571,0.578,14,22,0.636,14,53,67,11,5,10,15,20,73
Owen Klassen,Canadá,5,68,5,15,0.333,0,5,0,5,10,0.5,0.333,9,13,0.692,8,15,23,5,0,1,5,17,19
Panagiotis Vasilopoulos,Grecia,3,21,0,2,0,0,2,0,0,0,NA,0,0,0,NA,0,1,1,0,0,0,1,2,0
Pape Diop,Senegal,5,36,7,12,0.583,0,2,0,7,10,0.7,0.583,3,4,0.75,1,4,5,1,2,0,0,6,17
Patricio Garino,Argentina,8,194,21,52,0.404,8,20,0.4,13,32,0.406,0.481,15,16,0.938,7,19,26,8,12,5,7,22,65
Patrik Auda,República Checa,8,173,34,61,0.557,4,8,0.5,30,53,0.566,0.59,19,26,0.731,8,20,28,5,5,0,15,28,91
Patty Mills,Australia,8,271,61,123,0.496,23,57,0.404,38,66,0.576,0.589,37,43,0.86,7,11,18,31,7,2,28,13,182
Pau Ribas,España,8,139,12,28,0.429,8,22,0.364,4,6,0.667,0.571,5,6,0.833,1,12,13,10,5,0,4,13,37
Paul Biligha,Italia,5,96,12,21,0.571,0,0,NA,12,21,0.571,0.571,3,8,0.375,8,8,16,1,4,3,2,11,27
Paul Lacombe,Francia,3,28,3,5,0.6,0,1,0,3,4,0.75,0.6,0,0,NA,1,2,3,6,3,0,0,4,6
Paul Lee,Filipinas,5,64,10,30,0.333,3,18,0.167,7,12,0.583,0.383,3,4,0.75,2,1,3,2,2,0,2,7,26
Paul Zipser,Alemania,5,93,9,26,0.346,3,7,0.429,6,19,0.316,0.404,4,4,1,4,15,19,5,4,1,7,10,25
Paulius Jankunas,Lituania,5,46,4,18,0.222,0,3,0,4,15,0.267,0.222,14,15,0.933,1,8,9,3,1,1,2,3,22
Pavel Pumprla,República Checa,8,138,15,36,0.417,1,3,0.333,14,33,0.424,0.431,6,13,0.462,3,16,19,12,5,2,4,11,37
Pedro Chourio,Venezuela,5,66,9,21,0.429,4,14,0.286,5,7,0.714,0.524,0,0,NA,1,6,7,0,2,0,3,8,22
Petar Popovic,Montenegro,5,142,20,52,0.385,4,19,0.211,16,33,0.485,0.423,2,2,1,2,8,10,15,5,1,6,12,46
Philip Scrubb,Canadá,5,86,11,29,0.379,6,15,0.4,5,14,0.357,0.483,2,2,1,3,8,11,9,2,0,4,4,30
Pierre Oriola,España,8,104,12,25,0.48,0,8,0,12,17,0.706,0.48,3,4,0.75,11,18,29,1,2,0,1,13,27
Radhouane Slimane,Túnez,3,23,2,8,0.25,1,3,0.333,1,5,0.2,0.313,0,0,NA,3,1,4,0,1,1,3,3,5
Rafa Luz,Brasil,5,99,11,24,0.458,2,10,0.2,9,14,0.643,0.5,5,5,1,3,8,11,15,4,1,8,11,29
Ramon Clemente,Puerto Rico,5,65,6,14,0.429,1,6,0.167,5,8,0.625,0.464,3,3,1,5,10,15,0,1,0,9,5,16
Rasoul Mozafarivanani,Irán,4,31,3,6,0.5,1,2,0.5,2,4,0.5,0.583,5,6,0.833,2,1,3,5,2,0,4,1,12
Raymond Almazan,Filipinas,5,27,1,4,0.25,0,0,NA,1,4,0.25,0.25,1,2,0.5,1,2,3,1,0,0,3,5,3
Reggie Moore,Angola,5,114,9,25,0.36,8,17,0.471,1,8,0.125,0.52,1,4,0.25,2,17,19,6,1,0,6,11,27
Renaldas Seibutis,Lituania,5,70,6,17,0.353,1,4,0.25,5,13,0.385,0.382,0,0,NA,1,4,5,4,0,0,1,7,13
Renaldo Balkman,Puerto Rico,5,141,16,46,0.348,0,6,0,16,40,0.4,0.348,13,18,0.722,10,16,26,10,7,7,14,14,45
Ricky Rubio,España,8,211,41,94,0.436,12,31,0.387,29,63,0.46,0.5,37,44,0.841,7,30,37,48,12,0,28,18,131
Rigoberto Mendoza,República Dominicana,5,114,16,39,0.41,3,11,0.273,13,28,0.464,0.449,5,5,1,3,15,18,10,3,1,8,4,40
Rob Loe,Nueva Zelanda,5,117,18,36,0.5,12,23,0.522,6,13,0.462,0.667,7,12,0.583,10,14,24,16,2,2,10,20,55
Robert Bolick,Filipinas,5,71,15,32,0.469,7,18,0.389,8,14,0.571,0.578,6,6,1,3,3,6,5,0,0,7,2,43
Robin Benzing,Alemania,5,100,10,30,0.333,8,19,0.421,2,11,0.182,0.467,12,13,0.923,3,12,15,5,3,1,3,7,40
Rokas Giedraitis,Lituania,3,39,0,4,0,0,3,0,0,1,0,0,2,2,1,1,3,4,3,0,2,2,3,2
Ronald Ramon,República Dominicana,4,40,5,10,0.5,3,6,0.5,2,4,0.5,0.65,1,2,0.5,0,0,0,5,1,0,1,6,14
Ronald Roberts,República Dominicana,5,101,14,32,0.438,0,1,0,14,31,0.452,0.438,7,8,0.875,10,11,21,2,2,1,4,12,35
RR Pogoy,Filipinas,5,91,8,24,0.333,3,12,0.25,5,12,0.417,0.396,1,2,0.5,3,7,10,4,2,0,3,10,20
Rudy Fernandez,España,8,217,19,47,0.404,15,36,0.417,4,11,0.364,0.564,9,12,0.75,6,23,29,24,13,3,7,14,62
Rudy Gobert,Francia,8,210,27,43,0.628,0,0,NA,27,43,0.628,0.628,27,39,0.692,18,55,73,14,5,15,9,25,81
Rui Hachimura,Japón,3,90,13,30,0.433,0,4,0,13,26,0.5,0.433,14,20,0.7,4,13,17,7,5,0,4,8,40
Rui Zhao,China,5,117,10,30,0.333,3,14,0.214,7,16,0.438,0.383,7,9,0.778,2,5,7,9,5,0,4,12,30
Ryusei Shinoyama,Japón,3,53,4,8,0.5,2,5,0.4,2,3,0.667,0.625,0,0,NA,1,5,6,5,1,0,8,6,10
Sadiel Rojas,República Dominicana,5,101,11,23,0.478,4,8,0.5,7,15,0.467,0.565,0,0,NA,8,11,19,3,7,0,8,14,26
Sajjad Mashayekhi,Irán,5,99,8,23,0.348,2,5,0.4,6,18,0.333,0.391,5,9,0.556,8,10,18,3,4,0,8,15,23
Salah Mejri,Túnez,5,155,31,57,0.544,7,19,0.368,24,38,0.632,0.605,12,14,0.857,13,38,51,12,5,16,11,14,81
Samad Nik Bahrami,Irán,5,137,19,50,0.38,10,20,0.5,9,30,0.3,0.48,15,18,0.833,3,11,14,14,1,1,9,10,63
Sangjae Kang,Corea del Sur,5,49,5,8,0.625,2,4,0.5,3,4,0.75,0.75,0,0,NA,1,7,8,0,0,0,3,3,12
Scottie Wilbekin,Turquía,4,86,14,29,0.483,6,12,0.5,8,17,0.471,0.586,7,8,0.875,1,10,11,26,5,0,4,11,41
Sead Sehovic,Montenegro,5,30,2,9,0.222,0,2,0,2,7,0.286,0.222,3,5,0.6,1,4,5,1,1,0,2,3,7
Seiya Ando,Japón,3,63,3,12,0.25,1,4,0.25,2,8,0.25,0.292,2,3,0.667,1,3,4,4,2,0,3,2,9
Semen Antonov,Rusia,5,67,10,23,0.435,0,7,0,10,16,0.625,0.435,10,14,0.714,6,13,19,5,2,2,4,5,30
Semih Erden,Turquía,5,115,13,26,0.5,0,0,NA,13,26,0.5,0.5,8,13,0.615,5,14,19,4,4,3,14,21,34
Seounghyun Lee,Corea del Sur,5,145,18,39,0.462,5,16,0.313,13,23,0.565,0.526,5,6,0.833,5,19,24,7,1,2,10,7,46
Sergey Karasev,Rusia,5,67,5,15,0.333,3,9,0.333,2,6,0.333,0.433,7,9,0.778,1,5,6,6,5,0,6,7,20
Sergio Llull,España,8,193,31,87,0.356,13,49,0.265,18,38,0.474,0.431,9,11,0.818,0,10,10,30,4,0,17,19,84
Sertac Sanli,Turquía,4,45,5,9,0.556,0,0,NA,5,9,0.556,0.556,6,10,0.6,0,9,9,0,3,0,2,8,16
Shea Ili,Nueva Zelanda,5,104,13,27,0.481,3,6,0.5,10,21,0.476,0.537,23,28,0.821,3,12,15,25,3,3,6,13,52
Shuo Fang,China,5,108,14,35,0.4,7,24,0.292,7,11,0.636,0.5,4,4,1,1,7,8,8,6,0,6,10,39
Shuto Ando,Japón,4,30,2,13,0.154,1,11,0.091,1,2,0.5,0.192,0,0,NA,1,4,5,0,2,0,2,1,5
Souleyman Diabate,Costa de Marfil,5,129,17,49,0.347,7,19,0.368,10,30,0.333,0.418,1,1,1,4,5,9,19,5,0,10,5,42
Stanley Okoye,Nigeria,5,63,9,19,0.474,7,11,0.636,2,8,0.25,0.658,1,2,0.5,1,8,9,10,2,1,5,8,26
Stefan Bircevic,Serbia,6,52,10,22,0.455,5,13,0.385,5,9,0.556,0.568,4,8,0.5,2,15,17,3,3,1,2,9,29
Stefan Jovic,Serbia,8,200,24,49,0.49,7,22,0.318,17,27,0.63,0.561,1,2,0.5,7,24,31,43,8,2,16,21,56
Suad Sehovic,Montenegro,5,98,6,19,0.316,6,18,0.333,0,1,0,0.474,3,3,1,4,8,12,2,1,0,3,9,21
Sun Minghui,China,4,53,5,16,0.313,1,6,0.167,4,10,0.4,0.344,1,3,0.333,2,2,4,11,4,0,2,6,12
Sunhyung Kim,Corea del Sur,5,122,11,50,0.22,4,19,0.211,7,31,0.226,0.26,7,9,0.778,5,10,15,19,4,0,7,7,33
Tai Webster,Nueva Zelanda,5,137,24,55,0.436,4,21,0.19,20,34,0.588,0.473,15,20,0.75,1,19,20,24,2,0,20,18,67
Talib Zanna,Nigeria,4,32,2,8,0.25,1,2,0.5,1,6,0.167,0.313,2,4,0.5,3,5,8,4,3,1,3,3,7
Tayavek Gallizzi,Argentina,6,34,2,8,0.25,0,0,NA,2,8,0.25,0.25,6,6,1,3,3,6,0,3,1,4,15,10
Thanasis Antetokounmpo,Grecia,5,62,12,22,0.545,3,8,0.375,9,14,0.643,0.614,3,6,0.5,3,4,7,5,2,2,4,14,30
Thomas Abercrombie,Nueva Zelanda,5,137,16,36,0.444,6,17,0.353,10,19,0.526,0.528,10,14,0.714,8,20,28,5,3,4,5,12,48
Thomas Scrubb,Canadá,5,44,5,13,0.385,3,6,0.5,2,7,0.286,0.5,3,5,0.6,3,5,8,7,0,0,1,7,16
Tiegbe Bamba,Costa de Marfil,5,79,10,20,0.5,4,8,0.5,6,12,0.5,0.6,6,11,0.545,4,3,7,2,1,0,4,9,30
Tohi Smith-Milner,Nueva Zelanda,5,64,10,20,0.5,5,12,0.417,5,8,0.625,0.625,1,2,0.5,5,9,14,5,6,6,1,9,26
Tomas Satoransky,República Checa,8,265,42,92,0.457,13,27,0.481,29,65,0.446,0.527,27,30,0.9,6,39,45,68,7,3,22,14,124
Tomas Vyoral,República Checa,6,10,0,2,0,0,2,0,0,0,NA,0,0,0,NA,0,0,0,1,0,0,2,1,0
Troy Rosario,Filipinas,5,98,6,21,0.286,1,10,0.1,5,11,0.455,0.31,1,2,0.5,8,15,23,1,0,1,2,12,14
Vafessa Fofana,Costa de Marfil,5,110,4,23,0.174,1,10,0.1,3,13,0.231,0.196,7,9,0.778,4,9,13,12,6,3,18,13,16
Vander Joaquim,Angola,5,118,21,40,0.525,5,8,0.625,16,32,0.5,0.588,11,14,0.786,5,20,25,2,4,4,9,16,58
Vangelis Mantzaris,Grecia,2,16,1,1,1,1,1,1,0,0,NA,1.5,2,2,1,0,2,2,5,0,0,1,0,5
Vasilije Micic,Serbia,8,150,16,37,0.432,3,15,0.2,13,22,0.591,0.473,10,10,1,2,12,14,26,7,0,14,14,45
Victor Claver,España,8,209,27,48,0.563,6,19,0.316,21,29,0.724,0.625,8,10,0.8,15,24,39,13,12,5,10,21,68
Victor Liz,República Dominicana,5,132,20,52,0.385,7,20,0.35,13,32,0.406,0.452,18,22,0.818,5,9,14,10,7,1,17,7,65
Vincent Poirier,Francia,7,102,14,25,0.56,0,0,NA,14,25,0.56,0.56,10,12,0.833,11,16,27,5,1,2,6,11,38
Vitaly Fridzon,Rusia,5,115,13,33,0.394,3,10,0.3,10,23,0.435,0.439,4,7,0.571,4,8,12,9,8,0,6,11,33
Vitor Benite,Brasil,5,91,13,36,0.361,11,22,0.5,2,14,0.143,0.514,11,15,0.733,2,6,8,3,1,0,4,12,48
Vladimir Ivlev,Rusia,5,75,9,15,0.6,1,1,1,8,14,0.571,0.633,4,6,0.667,4,9,13,2,3,0,3,14,23
Vladimir Lucic,Serbia,8,174,16,34,0.471,4,14,0.286,12,20,0.6,0.529,21,24,0.875,7,17,24,7,6,2,2,22,57
Vojtech Hruban,República Checa,8,227,37,80,0.463,12,37,0.324,25,43,0.581,0.538,5,5,1,12,24,36,16,6,2,12,21,91
Windi Graterol,Venezuela,4,34,3,9,0.333,0,2,0,3,7,0.429,0.333,0,0,NA,9,6,15,2,0,1,1,8,6
Xane D'Almeida,Senegal,5,161,13,35,0.371,3,13,0.231,10,22,0.455,0.414,4,5,0.8,1,15,16,27,3,1,14,8,33
Xavi Rabaseda,España,4,17,0,2,0,0,1,0,0,1,0,0,0,0,NA,1,1,2,2,1,0,3,3,0
Xiaochuan Di,China,5,103,12,19,0.632,0,3,0,12,16,0.75,0.632,2,3,0.667,6,10,16,1,3,1,4,9,26
Yago Mateus Dos Santos,Brasil,2,17,1,7,0.143,0,5,0,1,2,0.5,0.143,3,3,1,1,0,1,4,1,0,2,1,5
Yanick Moreira,Angola,5,136,26,48,0.542,0,0,NA,26,48,0.542,0.542,8,11,0.727,16,27,43,3,5,1,8,17,60
Ioannis Bourousis,Grecia,5,84,8,20,0.4,4,11,0.364,4,9,0.444,0.5,4,4,1,5,14,19,5,3,0,5,11,24
Yigit Arslan,Turquía,3,17,1,3,0.333,0,2,0,1,1,1,0.333,0,0,NA,1,2,3,1,0,0,1,2,2
Yousef Abuwazaneh,Jordania,5,60,3,12,0.25,0,0,NA,3,12,0.25,0.25,1,4,0.25,7,3,10,1,3,0,3,7,7
Youssou Ndoye,Senegal,5,126,24,48,0.5,1,6,0.167,23,42,0.548,0.51,10,12,0.833,10,21,31,2,2,7,8,12,59
Yudai Baba,Japón,5,128,17,45,0.378,4,13,0.308,13,32,0.406,0.422,8,13,0.615,2,11,13,15,7,0,8,11,46
Yuta Watanabe,Japón,5,162,25,56,0.446,2,13,0.154,23,43,0.535,0.464,26,28,0.929,5,23,28,8,4,2,6,9,78
Zaid Abbas,Jordania,5,122,14,40,0.35,2,10,0.2,12,30,0.4,0.375,1,5,0.2,9,16,25,8,1,0,15,17,31
Zhao Jiwei,China,5,116,6,20,0.3,4,13,0.308,2,7,0.286,0.4,7,8,0.875,0,8,8,14,7,0,4,8,23
Zhelin Wang,China,5,103,14,28,0.5,0,0,NA,14,28,0.5,0.5,12,17,0.706,7,18,25,1,3,3,5,17,40
Zhou Qi,China,5,134,18,34,0.529,3,10,0.3,15,24,0.625,0.574,6,15,0.4,6,32,38,6,4,7,9,16,45
Ziyed Chennoufi,Túnez,5,56,3,14,0.214,1,5,0.2,2,9,0.222,0.25,1,2,0.5,2,0,2,3,2,0,2,8,8
