player,team,games,minutes_played,field_goals,field_goal_attempts,field_goal_percentage,three_point_field_goals,three_point_field_goal_attempts,three_point_field_goal_percentage,two_point_field_goals,two_point_field_goal_attempts,two_point_field_goal_percentage,effective_field_goal_percentage,free_throws,free_throws_attempts,free_throws_percentage,offensive_rebounds,defensive_rebounds,total_rebounds,assists,steals,blocks,turnovers,personal_fouls,points
Aaron Cel,Poland,8,157,21,52,.404,8,24,.333,13,28,.464,.481,1,2,.500,6,21,27,7,4,0,9,13,51
Aaron Geramipoor,Iran,5,84,23,33,.697,0,0,NA,23,33,.697,.697,6,10,.600,9,21,30,4,3,1,8,12,52
Abudurexiti Abudushalamu,China,4,22,2,5,.400,1,3,.333,1,2,.500,.500,2,2,1.000,1,1,2,0,1,0,3,4,7
Adam Hrycaniuk,Poland,8,164,20,37,.541,0,0,NA,20,37,.541,.541,9,14,.643,14,24,38,15,3,1,10,21,49
Adam Waczynski,Poland,8,251,34,80,.425,15,40,.375,19,40,.475,.519,28,30,.933,5,16,21,22,5,1,14,14,111
Agustin Caffaro,Argentina,6,16,3,5,.600,0,0,NA,3,5,.600,.600,2,3,.667,2,2,4,1,1,1,1,4,8
Ahmed Hamarsha,Jordan,5,101,7,18,.389,4,13,.308,3,5,.600,.500,1,2,.500,3,10,13,4,2,1,1,9,19
Ahmed Obeid,Jordan,3,13,1,3,.333,0,0,NA,1,3,.333,.333,0,0,NA,1,1,2,0,1,0,1,2,2
Ahmet Duverioglu,Jordan,4,122,26,43,.605,0,0,NA,26,43,.605,.605,13,20,.650,11,18,29,6,2,1,8,8,65
Ahmet Tuncer,Turkey,5,52,4,11,.364,1,5,.200,3,6,.500,.409,2,2,1.000,1,5,6,13,1,0,3,6,11
Ailun Guo,China,5,107,17,50,.340,3,16,.188,14,34,.412,.370,5,8,.625,4,3,7,19,6,0,6,12,42
A.J. Slaughter,Poland,8,238,39,98,.398,13,40,.325,26,58,.448,.464,15,17,.882,7,15,22,38,7,1,16,12,106
Al-Farouq Aminu,Nigeria,5,110,14,31,.452,2,6,.333,12,25,.480,.484,11,15,.733,5,28,33,18,7,5,10,7,41
Aleksa Popovic,Montenegro,4,27,2,6,.333,0,2,.000,2,4,.500,.333,1,2,.500,0,1,1,2,0,0,1,3,5
Alessandro Gentile,Italy,4,76,8,25,.320,3,4,.750,5,21,.238,.380,11,18,.611,3,8,11,7,1,0,6,6,30
Alex Franklin,Puerto Rico,5,74,5,13,.385,1,3,.333,4,10,.400,.423,0,0,NA,4,9,13,3,1,0,3,10,11
Alex Garcia,Brazil,5,112,17,40,.425,4,12,.333,13,28,.464,.475,12,15,.800,2,12,14,12,8,0,9,11,50
Alex Pledger,New Zealand,5,24,3,8,.375,0,0,NA,3,8,.375,.375,0,0,NA,2,5,7,2,0,0,0,3,6
Amath M'Baye,France,8,145,17,30,.567,10,18,.556,7,12,.583,.733,2,4,.500,5,10,15,2,0,2,6,15,46
Amedeo Della Valle,Italy,5,53,10,26,.385,5,17,.294,5,9,.556,.481,6,6,1.000,1,5,6,6,3,0,5,3,31
Amedeo Tessitori,Italy,5,48,14,20,.700,0,1,.000,14,19,.737,.700,4,6,.667,4,8,12,3,0,3,2,9,32
Amin Abu Hawwas,Jordan,4,23,5,9,.556,1,3,.333,4,6,.667,.611,2,2,1.000,1,1,2,0,1,1,2,2,13
Anderson Varejao,Brazil,5,112,21,37,.568,0,1,.000,21,36,.583,.568,8,9,.889,3,32,35,9,3,0,2,8,50
Andray Blatche,Philippines,5,165,30,75,.400,9,32,.281,21,43,.488,.460,10,16,.625,8,34,42,17,12,3,22,18,79
Andreas Obst,Germany,4,21,3,6,.500,3,5,.600,0,1,.000,.750,0,0,NA,0,2,2,3,0,0,2,3,9
Andrei Sopin,Russia,4,25,4,7,.571,1,4,.250,3,3,1.000,.643,0,0,NA,0,1,1,4,1,0,3,4,9
Andrew Albicy,France,8,155,13,30,.433,9,18,.500,4,12,.333,.583,3,4,.750,1,9,10,21,10,0,8,17,38
Andrew Bogut,Australia,8,143,31,49,.633,0,2,.000,31,47,.660,.633,2,6,.333,12,36,48,19,4,6,13,24,64
Andrew Nembhard,Canada,5,49,5,12,.417,2,6,.333,3,6,.500,.500,2,2,1.000,0,2,2,12,1,0,4,6,14
Andrey Vorontsevich,Russia,5,140,22,43,.512,8,20,.400,14,23,.609,.605,12,13,.923,6,29,35,14,4,2,5,13,64
Andrey Zubkov,Russia,5,114,18,42,.429,2,12,.167,16,30,.533,.452,9,11,.818,5,16,21,12,3,6,10,14,47
Angel Rodriguez,Puerto Rico,5,85,9,31,.290,3,13,.231,6,18,.333,.339,12,14,.857,5,9,14,12,5,0,13,14,33
Anthony Perez,Venezuela,2,17,0,5,.000,0,3,.000,0,2,.000,.000,1,2,.500,1,1,2,0,0,0,1,3,1
Ariel Filloy,Italy,3,43,5,12,.417,2,7,.286,3,5,.600,.500,1,1,1.000,0,6,6,8,3,0,4,6,13
Arman Zangeneh,Iran,4,45,4,11,.364,2,5,.400,2,6,.333,.455,1,2,.500,0,5,5,1,2,2,3,7,11
Arnas Butkevicius,Lithuania,5,51,6,8,.750,0,1,.000,6,7,.857,.750,2,3,.667,3,9,12,3,0,0,3,7,14
Aron Baynes,Australia,8,170,35,62,.565,11,21,.524,24,41,.585,.653,10,11,.909,12,32,44,14,3,4,9,18,91
Augusto Lima,Brazil,2,8,0,1,.000,0,0,NA,0,1,.000,.000,0,0,NA,0,1,1,0,0,0,1,4,0
Avi Koki Schafer,Japan,2,10,0,3,.000,0,0,NA,0,3,.000,.000,0,0,NA,0,1,1,0,1,0,2,0,0
Awudu Abass,Italy,4,84,12,23,.522,4,13,.308,8,10,.800,.609,4,4,1.000,2,10,12,3,3,1,6,5,32
Axel Toupane,France,8,62,6,11,.545,4,7,.571,2,4,.500,.727,2,4,.500,0,7,7,2,2,1,3,12,18
Babacar Toure,Senegal,4,63,14,25,.560,3,4,.750,11,21,.524,.620,1,1,1.000,8,1,9,1,2,0,3,7,32
Bali Coulibaly,Ivory Coast,2,8,1,3,.333,0,0,NA,1,3,.333,.333,2,2,1.000,2,0,2,0,0,0,0,0,4
Baru Adjehi,Ivory Coast,3,31,4,6,.667,0,0,NA,4,6,.667,.667,1,2,.500,2,4,6,3,0,1,1,6,9
Behnam Yakhchali,Iran,5,177,21,41,.512,12,25,.480,9,16,.563,.659,6,7,.857,3,11,14,15,9,1,7,4,60
Ben Uzoh,Nigeria,5,97,17,31,.548,0,3,.000,17,28,.607,.548,0,2,.000,3,5,8,11,2,1,6,7,34
Blake Schilb,Czech Republic,6,103,16,28,.571,11,17,.647,5,11,.455,.768,1,2,.500,0,8,8,14,4,1,3,2,44
Boban Marjanovic,Serbia,8,78,22,29,.759,0,1,.000,22,28,.786,.759,10,15,.667,8,12,20,5,1,3,10,12,54
Bogdan Bogdanovic,Serbia,8,224,60,108,.556,35,66,.530,25,42,.595,.718,28,35,.800,8,25,33,35,10,2,11,10,183
Bojan Dubljevic,Montenegro,5,128,14,34,.412,8,22,.364,6,12,.500,.529,14,18,.778,12,23,35,13,7,0,15,14,50
Brady Heslip,Canada,5,61,9,23,.391,7,18,.389,2,5,.400,.543,3,3,1.000,1,4,5,2,0,0,0,6,28
Brook Lopez,United States,7,66,6,27,.222,3,19,.158,3,8,.375,.278,3,5,.600,3,10,13,2,0,5,3,4,18
Bruno Caboclo,Brazil,5,134,11,31,.355,5,16,.313,6,15,.400,.435,1,2,.500,4,22,26,6,5,6,5,12,28
Bryan Pamba,Ivory Coast,5,95,8,26,.308,3,10,.300,5,16,.313,.365,3,4,.750,6,13,19,12,5,0,7,6,22
Cameron Gliddon,Australia,1,1,0,0,NA,0,0,NA,0,0,NA,NA,0,0,NA,0,0,0,0,0,0,0,0,0
Carlos Morais,Angola,5,156,25,59,.424,8,21,.381,17,38,.447,.492,5,8,.625,3,9,12,12,4,1,13,9,63
Cedi Osman,Turkey,5,163,38,76,.500,10,34,.294,28,42,.667,.566,16,19,.842,2,14,16,13,7,2,7,14,102
Chan Hee Park,South Korea,5,86,11,18,.611,0,3,.000,11,15,.733,.611,4,10,.400,2,8,10,18,7,1,11,5,26
Chimezie Metu,Nigeria,5,94,16,31,.516,5,9,.556,11,22,.500,.597,8,8,1.000,8,20,28,7,2,6,8,8,45
Chris Brady,Puerto Rico,3,16,0,3,.000,0,1,.000,0,2,.000,.000,2,2,1.000,1,3,4,0,2,0,0,5,2
Chris Goulding,Australia,8,142,18,49,.367,12,37,.324,6,12,.500,.490,10,11,.909,0,9,9,5,3,0,7,20,58
Cj Perez,Philippines,5,97,25,46,.543,5,15,.333,20,31,.645,.598,8,12,.667,7,9,16,13,4,0,14,10,63
Conor Morgan,Canada,4,44,8,17,.471,5,9,.556,3,8,.375,.618,4,4,1.000,4,5,9,1,2,2,8,9,25
Corey Webster,New Zealand,5,149,39,72,.542,24,44,.545,15,28,.536,.708,12,13,.923,3,20,23,28,5,0,8,10,114
Cory Joseph,Canada,5,132,29,63,.460,8,18,.444,21,45,.467,.524,9,10,.900,4,13,17,24,7,0,9,13,75
Cristiano Felicio,Brazil,5,80,13,22,.591,0,0,NA,13,22,.591,.591,5,6,.833,16,12,28,7,2,1,6,6,31
Daesung Lee,South Korea,3,47,9,25,.360,8,18,.444,1,7,.143,.520,4,5,.800,2,4,6,4,4,0,6,10,30
Dagoberto Pena,Dominican Republic,5,31,2,8,.250,2,6,.333,0,2,.000,.375,2,2,1.000,1,0,1,3,1,0,1,4,8
Daiki Tanaka,Japan,5,115,11,32,.344,5,14,.357,6,18,.333,.422,4,6,.667,2,3,5,9,6,0,7,7,31
Damian Kulig,Poland,8,159,22,50,.440,4,20,.200,18,30,.600,.480,20,26,.769,12,25,37,8,6,9,9,16,68
Daniel Hackett,Italy,5,121,10,32,.313,6,19,.316,4,13,.308,.406,13,20,.650,1,23,24,14,6,0,13,11,39
Daniel Theis,Germany,5,89,17,39,.436,1,9,.111,16,30,.533,.449,3,4,.750,9,21,30,1,6,3,6,16,38
Danilo Barthel,Germany,5,87,11,22,.500,1,7,.143,10,15,.667,.523,5,8,.625,5,15,20,2,3,2,2,5,28
Danilo Gallinari,Italy,5,149,26,49,.531,12,24,.500,14,25,.560,.653,22,28,.786,6,22,28,14,5,2,5,8,86
Dar Tucker,Jordan,5,165,32,78,.410,7,28,.250,25,50,.500,.455,34,39,.872,2,22,24,6,6,1,15,7,105
David Barlow,Australia,2,0,0,0,NA,0,0,NA,0,0,NA,NA,0,0,NA,0,0,0,0,0,0,0,0,0
David Huertas,Puerto Rico,5,132,27,57,.474,10,25,.400,17,32,.531,.561,7,8,.875,1,8,9,10,1,1,8,10,71
Dennis Schroder,Germany,5,164,29,70,.414,10,21,.476,19,49,.388,.486,30,37,.811,4,19,23,47,7,1,17,7,98
Deon Thompson,Ivory Coast,5,154,25,53,.472,8,17,.471,17,36,.472,.547,8,10,.800,10,22,32,8,5,3,11,8,66
Derek Needham,Montenegro,5,129,16,43,.372,11,35,.314,5,8,.625,.500,2,3,.667,0,3,3,25,7,1,12,14,45
Derrick White,United States,8,124,19,41,.463,2,12,.167,17,29,.586,.488,7,9,.778,2,8,10,20,10,0,11,14,47
Devon Collier,Puerto Rico,5,111,13,27,.481,0,1,.000,13,26,.500,.481,3,4,.750,7,13,20,2,2,1,3,12,29
Didi,Brazil,5,46,3,13,.231,2,6,.333,1,7,.143,.308,3,4,.750,1,8,9,3,4,1,0,5,11
Dino Radoncic,Montenegro,5,83,9,16,.563,1,4,.250,8,12,.667,.594,1,4,.250,8,14,22,3,2,5,5,9,20
Divaldo Mbunga,Angola,3,20,1,4,.250,0,1,.000,1,3,.333,.250,0,0,NA,0,1,1,2,0,1,1,2,2
Djibril Thiam,Senegal,2,26,3,13,.231,0,5,.000,3,8,.375,.231,1,2,.500,2,3,5,2,0,0,5,2,7
Dogus Balbay,Turkey,5,86,3,10,.300,1,5,.200,2,5,.400,.350,0,2,.000,8,9,17,21,5,2,2,9,7
Domantas Sabonis,Lithuania,4,95,15,31,.484,0,1,.000,15,30,.500,.484,12,17,.706,13,12,25,15,1,3,4,12,42
Dominik Olejniczak,Poland,5,14,4,8,.500,0,0,NA,4,8,.500,.500,0,0,NA,2,5,7,1,0,0,1,2,8
Donovan Mitchell,United States,8,217,41,88,.466,17,42,.405,24,46,.522,.563,6,8,.750,7,27,34,40,9,3,8,16,105
Dwight Lewis,Venezuela,5,87,17,33,.515,4,9,.444,13,24,.542,.576,2,2,1.000,2,5,7,5,2,1,3,7,40
Edgaras Ulanovas,Lithuania,5,111,12,26,.462,0,7,.000,12,19,.632,.462,12,14,.857,5,13,18,11,3,0,2,8,36
Eduardo Mingas,Angola,2,21,2,5,.400,0,0,NA,2,5,.400,.400,0,0,NA,2,3,5,1,1,0,2,3,4
Ege Arar,Turkey,2,11,1,3,.333,0,0,NA,1,3,.333,.333,0,2,.000,0,2,2,1,0,1,0,5,2
Ekpe Udoh,Nigeria,5,95,14,23,.609,0,0,NA,14,23,.609,.609,5,7,.714,7,11,18,4,4,5,2,7,33
Eloy Vargas,Dominican Republic,5,101,21,38,.553,0,2,.000,21,36,.583,.553,13,15,.867,9,18,27,3,1,3,4,15,55
Ersan Ilyasova,Turkey,3,98,16,44,.364,6,18,.333,10,26,.385,.432,10,11,.909,5,23,28,6,5,3,5,10,48
Ethan Rusbatch,New Zealand,5,51,6,17,.353,5,14,.357,1,3,.333,.500,1,2,.500,1,4,5,0,1,0,3,7,18
Eulis Baez,Dominican Republic,5,121,12,37,.324,5,21,.238,7,16,.438,.392,3,4,.750,6,16,22,8,6,2,3,9,32
Evan Fournier,France,8,225,58,138,.420,16,39,.410,42,99,.424,.478,26,36,.722,2,28,30,24,7,1,15,20,158
Evegeny Valiev,Russia,4,30,4,7,.571,0,0,NA,4,7,.571,.571,2,4,.500,4,2,6,2,1,1,0,3,10
Evgeny Baburin,Russia,5,52,4,9,.444,4,9,.444,0,0,NA,.667,1,2,.500,6,3,9,7,3,0,2,14,13
Facu Campazzo,Argentina,8,233,33,79,.418,18,46,.391,15,33,.455,.532,22,28,.786,6,28,34,62,16,1,21,15,106
Fadi Ibrahim,Jordan,5,120,13,35,.371,6,14,.429,7,21,.333,.457,4,6,.667,0,12,12,17,3,1,14,8,36
Finn Delaney,New Zealand,5,71,7,14,.500,0,3,.000,7,11,.636,.500,2,2,1.000,6,9,15,0,1,0,5,12,16
Frank Ntilikina,France,8,156,24,55,.436,8,24,.333,16,31,.516,.509,8,9,.889,4,17,21,20,8,1,11,15,64
Frejus Zerbo,Ivory Coast,5,53,5,11,.455,0,0,NA,5,11,.455,.455,0,1,.000,3,10,13,4,3,0,4,13,10
Furkan Korkmaz,Turkey,4,106,18,40,.450,7,18,.389,11,22,.500,.538,4,5,.800,4,10,14,7,6,1,6,6,47
Gabe Norwood,Philippines,5,88,2,13,.154,2,10,.200,0,3,.000,.231,0,0,NA,3,6,9,6,4,0,2,11,6
Gabe Vincent,Nigeria,5,93,20,40,.500,12,30,.400,8,10,.800,.650,5,7,.714,1,5,6,3,8,0,4,14,57
Gabriel Deck,Argentina,8,196,42,75,.560,6,16,.375,36,59,.610,.600,21,29,.724,9,16,25,7,9,1,7,14,111
Gary Browne,Puerto Rico,5,120,19,54,.352,2,13,.154,17,41,.415,.370,5,5,1.000,4,14,18,23,5,0,8,9,45
Gelvis Solano,Dominican Republic,5,122,12,39,.308,3,14,.214,9,25,.360,.346,2,11,.182,1,12,13,33,6,0,14,13,29
Georgios Papagiannis,Greece,4,45,9,17,.529,0,0,NA,9,17,.529,.529,1,1,1.000,3,10,13,1,2,4,1,7,19
Gerson Domingos,Angola,4,102,11,34,.324,5,16,.313,6,18,.333,.397,8,9,.889,3,7,10,10,1,0,13,6,35
Gerson Lukeny Goncalves,Angola,5,70,6,22,.273,1,8,.125,5,14,.357,.295,3,4,.750,1,4,5,8,2,1,6,6,16
Gian Clavell,Puerto Rico,5,93,11,41,.268,5,22,.227,6,19,.316,.329,9,12,.750,5,11,16,7,3,0,3,4,36
Giannis Antetokounmpo,Greece,5,125,24,46,.522,2,9,.222,22,37,.595,.543,24,34,.706,5,39,44,12,12,3,13,18,74
Giannoulis Larentzakis,Greece,4,38,5,9,.556,2,6,.333,3,3,1.000,.667,6,7,.857,0,2,2,5,3,1,4,6,18
Giorgos Printezis,Greece,5,109,21,44,.477,7,14,.500,14,30,.467,.557,12,17,.706,1,10,11,10,2,0,3,4,61
Gregory Vargas,Venezuela,5,103,10,33,.303,1,9,.111,9,24,.375,.318,10,12,.833,4,9,13,12,3,0,13,12,31
Grigory Motovilov,Russia,5,73,9,25,.360,2,10,.200,7,15,.467,.400,3,7,.429,0,5,5,6,2,0,10,8,23
Willy Hernangomez,Spain,8,103,22,42,.524,0,2,.000,22,40,.550,.524,12,19,.632,12,19,31,10,4,6,6,13,56
Guna Ra,South Korea,5,181,45,91,.495,3,7,.429,42,84,.500,.511,22,33,.667,26,38,64,9,7,6,12,9,115
Guy Edi,Ivory Coast,5,126,11,38,.289,5,18,.278,6,20,.300,.355,6,8,.750,4,12,16,9,1,0,9,6,33
Hamady N'Diaye,Senegal,4,44,3,4,.750,0,0,NA,3,4,.750,.750,1,2,.500,2,4,6,1,1,4,1,5,7
Hamed Haddadi,Iran,5,151,28,59,.475,4,7,.571,24,52,.462,.508,13,21,.619,12,42,54,22,3,6,22,15,73
Hamed Hosseinzadeh,Iran,2,12,0,2,.000,0,1,.000,0,1,.000,.000,0,0,NA,0,1,1,2,0,0,1,0,0
Harrison Barnes,United States,8,212,30,63,.476,9,27,.333,21,36,.583,.548,24,27,.889,12,25,37,12,10,1,9,13,93
Heejong Yang,South Korea,4,55,2,10,.200,2,9,.222,0,1,.000,.300,2,2,1.000,2,9,11,6,3,1,3,10,8
Heissler Guillent,Venezuela,5,144,26,61,.426,12,28,.429,14,33,.424,.525,1,3,.333,3,7,10,31,5,0,8,7,65
Hoon Heo,South Korea,5,44,7,20,.350,4,9,.444,3,11,.273,.450,3,4,.750,1,1,2,4,2,0,2,2,21
Hyogeun Jeong,South Korea,4,59,4,18,.222,2,10,.200,2,8,.250,.278,2,2,1.000,1,8,9,1,1,1,1,4,12
Ibrahima Fall Faye,Senegal,3,83,10,30,.333,3,13,.231,7,17,.412,.383,4,8,.500,8,12,20,5,2,5,6,11,27
Ike Diogu,Nigeria,5,86,12,36,.333,3,15,.200,9,21,.429,.375,5,7,.714,7,22,29,4,1,2,7,8,32
Ike Iroegbu,Nigeria,5,106,14,38,.368,4,15,.267,10,23,.435,.421,9,11,.818,0,11,11,14,4,0,10,11,41
Ioannis Papapetrou,Greece,5,113,14,33,.424,6,18,.333,8,15,.533,.515,3,5,.600,5,11,16,2,4,1,3,4,37
Isaac Fotu,New Zealand,5,123,34,51,.667,2,8,.250,32,43,.744,.686,22,30,.733,7,23,30,8,1,0,8,12,92
Isaiah Pineiro,Puerto Rico,5,81,11,26,.423,1,6,.167,10,20,.500,.442,7,8,.875,4,10,14,3,5,0,2,10,30
Ismet Akpinar,Germany,5,96,8,26,.308,5,15,.333,3,11,.273,.404,0,0,NA,4,7,11,2,1,0,2,13,21
Jakub Sirina,Czech Republic,6,33,2,7,.286,1,4,.250,1,3,.333,.357,2,4,.500,0,0,0,9,0,0,3,6,7
James Birsen,Turkey,5,89,12,24,.500,1,8,.125,11,16,.688,.521,6,6,1.000,8,16,24,1,1,0,6,4,31
Japeth Aguilar,Philippines,5,105,11,30,.367,1,4,.250,10,26,.385,.383,1,2,.500,7,8,15,5,0,1,3,11,24
Jaromir Bohacik,Czech Republic,8,243,45,101,.446,20,47,.426,25,54,.463,.545,12,15,.800,8,24,32,19,2,1,12,25,122
Javier Beiran,Spain,4,17,2,5,.400,0,3,.000,2,2,1.000,.400,0,0,NA,3,4,7,0,1,0,0,0,4
Javier Mojica,Puerto Rico,5,39,4,18,.222,0,4,.000,4,14,.286,.222,2,2,1.000,3,6,9,1,4,1,0,4,10
Jaylen Brown,United States,8,160,26,58,.448,6,17,.353,20,41,.488,.500,5,11,.455,11,23,34,11,5,2,4,14,63
Jayson Tatum,United States,2,49,7,22,.318,2,8,.250,5,14,.357,.364,5,6,.833,3,12,15,5,2,3,4,4,21
Jeff Brooks,Italy,5,85,9,16,.563,2,6,.333,7,10,.700,.625,2,3,.667,9,12,21,5,8,6,2,12,22
Jhornan Jose Zamora,Venezuela,5,101,14,44,.318,9,30,.300,5,14,.357,.420,2,3,.667,1,5,6,5,2,0,2,8,39
Jianlian Yi,China,5,138,31,60,.517,5,14,.357,26,46,.565,.558,22,36,.611,9,30,39,6,5,3,13,12,89
Quino Colom,Spain,5,27,3,6,.500,1,3,.333,2,3,.667,.583,0,0,NA,1,2,3,6,1,0,2,3,7
Jock Landale,Australia,8,148,20,39,.513,7,15,.467,13,24,.542,.603,3,6,.500,4,23,27,6,2,2,13,14,50
Joe Harris,United States,8,170,23,45,.511,13,26,.500,10,19,.526,.656,5,6,.833,9,22,31,10,4,0,8,21,64
Joe Ingles,Australia,8,271,30,68,.441,10,38,.263,20,30,.667,.515,14,16,.875,1,48,49,45,13,3,24,18,84
Johannes Thiemann,Germany,1,8,2,3,.667,0,0,NA,2,3,.667,.667,1,1,1.000,1,2,3,0,0,0,2,1,5
Johannes Voigtmann,Germany,5,101,21,33,.636,10,18,.556,11,15,.733,.788,5,7,.714,8,19,27,14,4,3,11,13,57
Johnkyu Kim,South Korea,3,25,2,11,.182,0,0,NA,2,11,.182,.182,0,0,NA,2,3,5,1,1,0,3,5,4
Joji Takeuchi,Japan,5,92,4,14,.286,1,4,.250,3,10,.300,.321,7,10,.700,4,8,12,4,1,0,5,4,16
Jonas Maciulis,Lithuania,5,89,7,22,.318,5,13,.385,2,9,.222,.432,5,6,.833,4,14,18,6,5,0,2,13,24
Jonas Valanciunas,Lithuania,5,113,27,42,.643,0,1,.000,27,41,.659,.643,16,22,.727,13,31,44,5,5,8,5,13,70
Jordan Dasuqi,Jordan,5,54,2,6,.333,1,5,.200,1,1,1.000,.417,0,0,NA,0,2,2,1,1,0,1,4,5
Jordan Ngatai,New Zealand,3,23,1,2,.500,1,1,1.000,0,1,.000,.750,0,0,NA,0,2,2,0,0,0,1,3,3
Jordan Nwora,Nigeria,2,51,8,24,.333,3,11,.273,5,13,.385,.396,3,4,.750,0,7,7,4,6,0,4,4,22
Jorge Diaz,Puerto Rico,5,68,9,21,.429,2,4,.500,7,17,.412,.476,1,2,.500,3,11,14,2,1,3,5,11,21
Jose Antonio,Angola,5,92,8,21,.381,5,13,.385,3,8,.375,.500,6,8,.750,2,5,7,3,5,1,4,12,27
Jose Vargas,Venezuela,5,81,6,22,.273,3,12,.250,3,10,.300,.341,0,2,.000,3,7,10,4,5,1,6,13,15
Josh Okogie,Nigeria,5,120,18,42,.429,8,19,.421,10,23,.435,.524,19,21,.905,2,16,18,22,12,6,10,8,63
Juan Hernangomez,Spain,8,185,30,52,.577,11,25,.440,19,27,.704,.683,13,19,.684,13,30,43,5,8,3,7,23,84
Juan Jose Garcia,Dominican Republic,4,21,1,6,.167,1,5,.200,0,1,.000,.250,0,2,.000,1,3,4,1,1,1,2,3,3
Juan Miguel Suero,Dominican Republic,4,19,0,1,.000,0,0,NA,0,1,.000,.000,2,2,1.000,1,2,3,0,0,0,1,2,2
June Mar Fajardo,Philippines,5,86,11,23,.478,0,0,NA,11,23,.478,.478,13,16,.813,10,15,25,3,4,2,6,8,35
Junfei Ren,China,3,24,1,3,.333,0,0,NA,1,3,.333,.333,0,0,NA,0,3,3,1,0,0,4,3,2
Junghyun Lee,South Korea,4,104,12,35,.343,9,28,.321,3,7,.429,.471,7,10,.700,1,15,16,16,1,1,11,13,40
Junyong Choi,South Korea,5,83,4,15,.267,3,11,.273,1,4,.250,.367,3,6,.500,4,8,12,6,0,4,5,10,14
Kamil Laczynski,Poland,4,11,0,5,.000,0,4,.000,0,1,.000,.000,0,0,NA,1,0,1,2,1,0,1,4,0
Karol Gruszecki,Poland,7,41,7,16,.438,2,10,.200,5,6,.833,.500,2,4,.500,1,8,9,1,3,0,5,1,18
Kaza Kajami-Keane,Canada,4,25,4,11,.364,2,5,.400,2,6,.333,.455,5,8,.625,1,2,3,4,2,0,3,2,15
Kelanbaike Makan,China,1,0,0,0,NA,0,0,NA,0,0,NA,NA,0,0,NA,0,0,0,0,0,0,0,0,0
Kemba Walker,United States,7,178,36,74,.486,15,39,.385,21,35,.600,.588,14,20,.700,5,16,21,38,6,2,12,16,101
Kevin Pangos,Canada,5,127,16,46,.348,7,23,.304,9,23,.391,.424,2,3,.667,2,7,9,26,6,0,5,11,41
Khem Birch,Canada,5,125,22,38,.579,0,4,.000,22,34,.647,.579,14,20,.700,20,15,35,8,10,7,7,9,58
Khris Middleton,United States,8,158,28,64,.438,10,28,.357,18,36,.500,.516,13,14,.929,10,29,39,19,5,0,8,17,79
Kiefer Ravena,Philippines,5,89,6,31,.194,4,19,.211,2,12,.167,.258,8,11,.727,2,5,7,8,3,0,6,10,24
Kostas Papanikolaou,Greece,5,116,5,25,.200,2,14,.143,3,11,.273,.240,7,7,1.000,8,12,20,7,3,5,0,12,19
Kostas Sloukas,Greece,5,127,17,42,.405,5,18,.278,12,24,.500,.464,10,13,.769,1,11,12,23,2,0,4,9,49
Kosuke Takeuchi,Japan,3,31,0,3,.000,0,0,NA,0,3,.000,.000,5,6,.833,4,4,8,1,2,0,0,3,5
Kyle Wiltjer,Canada,5,117,28,57,.491,15,36,.417,13,21,.619,.623,11,13,.846,5,10,15,5,3,0,5,6,82
Lamine Sambe,Senegal,5,122,13,44,.295,7,27,.259,6,17,.353,.375,0,0,NA,1,3,4,11,3,0,8,12,33
Leandro Barbosa,Brazil,5,113,24,56,.429,4,11,.364,20,45,.444,.464,16,19,.842,0,8,8,11,3,1,8,10,68
Leandro Jacques Conceicao,Angola,4,72,5,16,.313,2,9,.222,3,7,.429,.375,0,0,NA,0,4,4,5,1,1,3,9,12
Leonel Paulo,Angola,5,99,15,23,.652,1,3,.333,14,20,.700,.674,11,16,.688,3,12,15,10,3,2,5,15,42
Louis Cyrille Jean Benoit A Sie,Ivory Coast,2,9,0,1,.000,0,1,.000,0,0,NA,.000,0,0,NA,1,0,1,0,0,0,0,1,0
Louis Labeyrie,France,5,47,6,8,.750,2,4,.500,4,4,1.000,.875,0,0,NA,3,10,13,1,0,1,3,6,14
Luca Vildoza,Argentina,8,132,13,34,.382,8,25,.320,5,9,.556,.500,12,13,.923,0,12,12,17,12,1,11,17,46
Luca Vitali,Italy,4,34,1,5,.200,0,2,.000,1,3,.333,.200,0,0,NA,0,0,0,6,0,1,5,5,2
Lucio Redivo,Argentina,4,18,2,11,.182,1,8,.125,1,3,.333,.227,2,2,1.000,0,1,1,3,1,0,2,0,7
Luigi Datome,Italy,4,90,16,27,.593,6,12,.500,10,15,.667,.704,4,5,.800,1,10,11,8,3,3,5,11,42
Luis Bethelmy,Venezuela,4,38,6,12,.500,4,8,.500,2,4,.500,.667,3,6,.500,3,9,12,1,0,0,1,4,19
Luis Montero,Dominican Republic,5,96,10,29,.345,5,16,.313,5,13,.385,.431,3,6,.500,4,10,14,3,7,3,4,12,28
Luis Scola,Argentina,8,236,46,106,.434,11,29,.379,35,77,.455,.486,40,46,.870,14,51,65,14,6,3,15,24,143
Lukas Lekavicius,Lithuania,5,88,24,37,.649,3,9,.333,21,28,.750,.689,14,15,.933,0,8,8,9,5,0,6,9,65
Lukas Palyza,Czech Republic,4,17,2,6,.333,2,6,.333,0,0,NA,.500,0,0,NA,2,4,6,3,1,0,1,3,6
Lukasz Koszarek,Poland,8,110,7,24,.292,6,16,.375,1,8,.125,.417,0,0,NA,1,5,6,20,3,0,8,10,20
Mahmoud Abdeen,Jordan,5,76,11,22,.500,5,13,.385,6,9,.667,.614,0,0,NA,1,5,6,9,3,0,9,10,27
Makhtar Gueye,Senegal,3,23,5,13,.385,4,9,.444,1,4,.250,.538,0,0,NA,1,1,2,0,0,0,0,3,14
Makoto Hiejima,Japan,5,90,9,28,.321,2,10,.200,7,18,.389,.357,2,4,.500,1,5,6,6,3,0,11,11,22
Makram Ben Romdhane,Tunisia,5,141,25,49,.510,6,15,.400,19,34,.559,.571,9,19,.474,17,19,36,19,9,2,8,16,65
Mantas Kalnietis,Lithuania,5,117,21,41,.512,7,19,.368,14,22,.636,.598,1,2,.500,1,10,11,27,3,0,7,7,50
Maodo Lo,Germany,5,106,10,23,.435,4,12,.333,6,11,.545,.522,6,9,.667,1,13,14,16,4,0,1,9,30
Marc Gasol,Spain,8,228,37,87,.425,7,31,.226,30,56,.536,.466,34,45,.756,3,41,44,33,9,9,14,15,115
Marcelo Huertas,Brazil,5,92,16,38,.421,3,9,.333,13,29,.448,.461,3,3,1.000,2,8,10,24,2,0,5,7,38
Marco Belinelli,Italy,5,145,24,60,.400,9,27,.333,15,33,.455,.475,18,25,.720,3,17,20,16,6,0,8,8,75
Marcos Delia,Argentina,8,182,25,41,.610,0,0,NA,25,41,.610,.610,6,16,.375,11,26,37,4,1,9,6,18,56
Marcus Smart,United States,5,89,10,21,.476,3,10,.300,7,11,.636,.548,9,15,.600,2,5,7,6,4,1,3,9,32
Marius Grigonis,Lithuania,5,99,19,42,.452,4,12,.333,15,30,.500,.500,9,9,1.000,1,8,9,6,6,0,8,11,51
Mark Barroca,Philippines,4,45,6,13,.462,1,5,.200,5,8,.625,.500,2,2,1.000,2,2,4,1,1,0,4,8,15
Marko Guduric,Serbia,7,105,12,29,.414,7,20,.350,5,9,.556,.534,8,10,.800,2,6,8,8,5,1,7,6,39
Marko Simonovic,Serbia,8,106,10,21,.476,4,11,.364,6,10,.600,.571,0,0,NA,3,10,13,2,3,1,4,11,24
Marko Todorovic,Montenegro,5,54,4,10,.400,0,1,.000,4,9,.444,.400,5,7,.714,2,5,7,2,6,3,3,11,13
Marquinhos Vieira,Brazil,5,96,19,37,.514,8,21,.381,11,16,.688,.622,5,6,.833,2,8,10,2,5,0,4,7,51
Martin Kriz,Czech Republic,8,89,10,27,.370,0,5,.000,10,22,.455,.370,0,0,NA,10,6,16,5,3,0,4,6,20
Martin Peterka,Czech Republic,8,91,18,31,.581,9,15,.600,9,16,.563,.726,2,2,1.000,7,10,17,7,2,1,5,2,47
Mason Plumlee,United States,6,47,3,9,.333,0,0,NA,3,9,.333,.333,2,3,.667,5,11,16,2,0,1,5,1,8
Mateusz Ponitka,Poland,8,229,33,66,.500,7,17,.412,26,49,.531,.553,35,47,.745,7,47,54,13,11,7,19,19,108
Mathias Lessort,France,6,72,8,17,.471,0,0,NA,8,17,.471,.471,7,13,.538,6,7,13,2,0,3,2,10,23
Matthew Dellavedova,Australia,8,245,23,69,.333,14,39,.359,9,30,.300,.435,11,15,.733,10,25,35,50,5,0,20,17,71
Maurice Ndour,Senegal,5,136,20,53,.377,1,10,.100,19,43,.442,.387,10,12,.833,5,16,21,7,10,3,13,13,51
Maxi Kleber,Germany,5,116,21,41,.512,5,18,.278,16,23,.696,.573,9,9,1.000,6,9,15,3,5,9,6,6,56
Maximo Fjellerup,Argentina,7,59,7,11,.636,1,2,.500,6,9,.667,.682,1,4,.250,1,14,15,3,5,1,1,9,16
Melih Mahmutoglu,Turkey,5,156,37,64,.578,15,31,.484,22,33,.667,.695,4,5,.800,4,4,8,5,4,0,4,4,93
Melvin Ejim,Canada,5,122,14,30,.467,4,14,.286,10,16,.625,.533,10,11,.909,6,21,27,10,10,2,8,14,42
Michael Carrera,Venezuela,5,82,15,28,.536,0,3,.000,15,25,.600,.536,20,26,.769,12,13,25,5,4,3,7,14,50
Michael Eric,Nigeria,4,51,15,19,.789,0,0,NA,15,19,.789,.789,4,9,.444,7,8,15,2,5,4,4,8,34
Michael Roll,Tunisia,5,164,29,63,.460,8,24,.333,21,39,.538,.524,5,6,.833,2,9,11,19,5,0,7,12,71
Michael Rostampour,Iran,5,83,6,16,.375,3,10,.300,3,6,.500,.469,5,8,.625,3,10,13,2,6,0,2,10,20
Michal Sokolowski,Poland,8,142,21,35,.600,5,11,.455,16,24,.667,.671,13,14,.929,11,11,22,6,5,4,5,22,60
Miguel Ruiz,Venezuela,5,116,10,19,.526,0,0,NA,10,19,.526,.526,1,1,1.000,15,23,38,4,7,0,4,17,21
Mikhail Kulagin,Russia,5,105,15,47,.319,11,30,.367,4,17,.235,.436,12,12,1.000,0,7,7,8,3,0,10,11,53
Milko Bjelica,Montenegro,5,84,17,37,.459,3,13,.231,14,24,.583,.500,2,2,1.000,5,10,15,1,4,3,2,10,39
Mindaugas Kuzminskas,Lithuania,5,83,14,31,.452,3,11,.273,11,20,.550,.500,4,7,.571,8,6,14,1,3,1,9,8,35
Miroslav Raduljica,Serbia,7,67,11,24,.458,0,0,NA,11,24,.458,.458,21,23,.913,3,12,15,11,5,2,10,15,43
Mitchell Creek,Australia,8,92,7,15,.467,0,2,.000,7,13,.538,.467,8,14,.571,8,13,21,4,2,1,2,13,22
Mohamed Abassi,Tunisia,1,10,0,1,.000,0,0,NA,0,1,.000,.000,1,2,.500,0,1,1,1,0,0,0,3,1
Mohamed Deba Kone,Ivory Coast,4,74,12,32,.375,0,3,.000,12,29,.414,.375,3,5,.600,9,7,16,4,3,0,2,6,27
Mohammad Hassanzadeh,Iran,4,47,7,13,.538,0,1,.000,7,12,.583,.538,3,7,.429,4,6,10,3,1,0,1,7,17
Mohammad Jamshidi,Iran,5,136,18,45,.400,2,11,.182,16,34,.471,.422,10,12,.833,2,13,15,18,1,1,7,9,48
Mohammad Shaher,Jordan,4,45,5,17,.294,0,0,NA,5,17,.294,.294,4,5,.800,5,4,9,3,4,1,6,8,14
Mokhtar Ghayaza,Tunisia,2,17,3,5,.600,0,0,NA,3,5,.600,.600,1,2,.500,0,2,2,1,0,0,1,2,7
Momar Ndoye,Senegal,5,35,0,4,.000,0,0,NA,0,4,.000,.000,1,2,.500,3,3,6,1,2,0,0,2,1
Mouhamed Hadidane,Tunisia,5,76,14,27,.519,6,11,.545,8,16,.500,.630,2,4,.500,2,11,13,3,0,1,3,6,36
Mouhammad Faye,Senegal,5,144,16,49,.327,8,28,.286,8,21,.381,.408,9,13,.692,5,12,17,10,7,4,8,11,49
Mourad El Mabrouk,Tunisia,5,144,13,40,.325,6,25,.240,7,15,.467,.400,4,5,.800,4,6,10,12,1,1,4,5,36
Mousa AL Awadi,Jordan,5,99,11,26,.423,6,15,.400,5,11,.455,.538,0,0,NA,2,6,8,6,3,0,7,7,28
Myles Turner,United States,8,154,25,53,.472,3,10,.300,22,43,.512,.500,8,13,.615,13,41,54,0,5,14,9,18,61
Nando De Colo,France,8,189,42,77,.545,13,31,.419,29,46,.630,.630,35,39,.897,3,10,13,27,7,0,18,18,132
Nathan Sobey,Australia,2,5,1,1,1.000,0,0,NA,1,1,1.000,1.000,0,0,NA,0,0,0,0,0,0,0,1,2
Nemanja Bjelica,Serbia,7,150,24,56,.429,12,28,.429,12,28,.429,.536,15,18,.833,12,21,33,19,6,4,9,13,75
Nemanja Radovic,Montenegro,2,16,2,5,.400,0,0,NA,2,5,.400,.400,0,0,NA,3,2,5,1,0,1,0,5,4
Nestor Colmenares,Venezuela,5,130,19,47,.404,2,8,.250,17,39,.436,.426,6,9,.667,15,14,29,10,7,1,6,16,46
Nicholas Kay,Australia,8,162,26,48,.542,1,6,.167,25,42,.595,.552,10,10,1.000,21,19,40,8,0,0,5,6,63
Nick Calathes,Greece,5,143,27,55,.491,10,24,.417,17,31,.548,.582,3,7,.429,3,19,22,27,8,0,13,13,67
Nick Fazekas,Japan,5,138,28,58,.483,9,16,.563,19,42,.452,.560,7,11,.636,11,26,37,6,5,1,9,8,72
Nicolas Batum,France,7,209,18,45,.400,8,30,.267,10,15,.667,.489,7,10,.700,3,22,25,17,5,8,5,11,51
Nicolas Brussino,Argentina,8,120,16,29,.552,7,17,.412,9,12,.750,.672,1,2,.500,6,15,21,9,2,1,5,12,40
Nicolas Laprovittola,Argentina,8,179,23,72,.319,15,49,.306,8,23,.348,.424,19,23,.826,3,15,18,29,12,0,14,16,80
Niels Giffey,Germany,5,21,1,5,.200,0,1,.000,1,4,.250,.200,0,0,NA,1,0,1,1,0,0,3,3,2
Nikita Kurbanov,Russia,5,138,15,32,.469,3,9,.333,12,23,.522,.516,15,23,.652,5,26,31,18,2,1,9,17,48
Nikola Ivanovic,Montenegro,4,92,17,36,.472,6,19,.316,11,17,.647,.556,7,8,.875,1,6,7,15,5,1,9,12,47
Nikola Jokic,Serbia,8,181,34,50,.680,4,10,.400,30,40,.750,.720,20,25,.800,13,47,60,38,2,4,23,18,92
Nikola Milutinov,Serbia,8,115,21,27,.778,0,0,NA,21,27,.778,.778,14,20,.700,5,13,18,6,1,1,2,9,56
Nikola Vucevic,Montenegro,5,119,30,63,.476,4,10,.400,26,53,.491,.508,9,12,.750,3,29,32,6,4,3,8,6,73
Nizar Knioua,Tunisia,4,42,3,7,.429,2,5,.400,1,2,.500,.571,0,0,NA,0,1,1,2,1,0,5,4,8
Noe-Charles Abouo,Ivory Coast,5,133,25,56,.446,8,21,.381,17,35,.486,.518,9,11,.818,6,9,15,7,5,0,8,7,67
Olek Balcerowski,Poland,8,108,7,18,.389,1,11,.091,6,7,.857,.417,5,13,.385,3,12,15,4,2,0,4,9,20
Olimpio Cipriano,Angola,3,24,2,13,.154,0,8,.000,2,5,.400,.154,0,1,.000,0,0,0,1,1,0,2,1,4
Omar Abada,Tunisia,5,158,16,38,.421,4,15,.267,12,23,.522,.474,17,20,.850,2,12,14,22,13,0,8,8,53
Omar Mouhli,Tunisia,1,15,2,6,.333,1,4,.250,1,2,.500,.417,1,2,.500,0,0,0,1,1,0,1,0,6
Ondrej Balvin,Czech Republic,8,211,29,51,.569,1,2,.500,28,49,.571,.578,14,22,.636,14,53,67,11,5,10,15,20,73
Owen Klassen,Canada,5,68,5,15,.333,0,5,.000,5,10,.500,.333,9,13,.692,8,15,23,5,0,1,5,17,19
Panagiotis Vasilopoulos,Greece,3,21,0,2,.000,0,2,.000,0,0,NA,.000,0,0,NA,0,1,1,0,0,0,1,2,0
Pape Diop,Senegal,5,36,7,12,.583,0,2,.000,7,10,.700,.583,3,4,.750,1,4,5,1,2,0,0,6,17
Patricio Garino,Argentina,8,194,21,52,.404,8,20,.400,13,32,.406,.481,15,16,.938,7,19,26,8,12,5,7,22,65
Patrik Auda,Czech Republic,8,173,34,61,.557,4,8,.500,30,53,.566,.590,19,26,.731,8,20,28,5,5,0,15,28,91
Patty Mills,Australia,8,271,61,123,.496,23,57,.404,38,66,.576,.589,37,43,.860,7,11,18,31,7,2,28,13,182
Pau Ribas,Spain,8,139,12,28,.429,8,22,.364,4,6,.667,.571,5,6,.833,1,12,13,10,5,0,4,13,37
Paul Biligha,Italy,5,96,12,21,.571,0,0,NA,12,21,.571,.571,3,8,.375,8,8,16,1,4,3,2,11,27
Paul Lacombe,France,3,28,3,5,.600,0,1,.000,3,4,.750,.600,0,0,NA,1,2,3,6,3,0,0,4,6
Paul Lee,Philippines,5,64,10,30,.333,3,18,.167,7,12,.583,.383,3,4,.750,2,1,3,2,2,0,2,7,26
Paul Zipser,Germany,5,93,9,26,.346,3,7,.429,6,19,.316,.404,4,4,1.000,4,15,19,5,4,1,7,10,25
Paulius Jankunas,Lithuania,5,46,4,18,.222,0,3,.000,4,15,.267,.222,14,15,.933,1,8,9,3,1,1,2,3,22
Pavel Pumprla,Czech Republic,8,138,15,36,.417,1,3,.333,14,33,.424,.431,6,13,.462,3,16,19,12,5,2,4,11,37
Pedro Chourio,Venezuela,5,66,9,21,.429,4,14,.286,5,7,.714,.524,0,0,NA,1,6,7,0,2,0,3,8,22
Petar Popovic,Montenegro,5,142,20,52,.385,4,19,.211,16,33,.485,.423,2,2,1.000,2,8,10,15,5,1,6,12,46
Philip Scrubb,Canada,5,86,11,29,.379,6,15,.400,5,14,.357,.483,2,2,1.000,3,8,11,9,2,0,4,4,30
Pierre Oriola,Spain,8,104,12,25,.480,0,8,.000,12,17,.706,.480,3,4,.750,11,18,29,1,2,0,1,13,27
Radhouane Slimane,Tunisia,3,23,2,8,.250,1,3,.333,1,5,.200,.313,0,0,NA,3,1,4,0,1,1,3,3,5
Rafa Luz,Brazil,5,99,11,24,.458,2,10,.200,9,14,.643,.500,5,5,1.000,3,8,11,15,4,1,8,11,29
Ramon Clemente,Puerto Rico,5,65,6,14,.429,1,6,.167,5,8,.625,.464,3,3,1.000,5,10,15,0,1,0,9,5,16
Rasoul Mozafarivanani,Iran,4,31,3,6,.500,1,2,.500,2,4,.500,.583,5,6,.833,2,1,3,5,2,0,4,1,12
Raymond Almazan,Philippines,5,27,1,4,.250,0,0,NA,1,4,.250,.250,1,2,.500,1,2,3,1,0,0,3,5,3
Reggie Moore,Angola,5,114,9,25,.360,8,17,.471,1,8,.125,.520,1,4,.250,2,17,19,6,1,0,6,11,27
Renaldas Seibutis,Lithuania,5,70,6,17,.353,1,4,.250,5,13,.385,.382,0,0,NA,1,4,5,4,0,0,1,7,13
Renaldo Balkman,Puerto Rico,5,141,16,46,.348,0,6,.000,16,40,.400,.348,13,18,.722,10,16,26,10,7,7,14,14,45
Ricky Rubio,Spain,8,211,41,94,.436,12,31,.387,29,63,.460,.500,37,44,.841,7,30,37,48,12,0,28,18,131
Rigoberto Mendoza,Dominican Republic,5,114,16,39,.410,3,11,.273,13,28,.464,.449,5,5,1.000,3,15,18,10,3,1,8,4,40
Rob Loe,New Zealand,5,117,18,36,.500,12,23,.522,6,13,.462,.667,7,12,.583,10,14,24,16,2,2,10,20,55
Robert Bolick,Philippines,5,71,15,32,.469,7,18,.389,8,14,.571,.578,6,6,1.000,3,3,6,5,0,0,7,2,43
Robin Benzing,Germany,5,100,10,30,.333,8,19,.421,2,11,.182,.467,12,13,.923,3,12,15,5,3,1,3,7,40
Rokas Giedraitis,Lithuania,3,39,0,4,.000,0,3,.000,0,1,.000,.000,2,2,1.000,1,3,4,3,0,2,2,3,2
Ronald Ramon,Dominican Republic,4,40,5,10,.500,3,6,.500,2,4,.500,.650,1,2,.500,0,0,0,5,1,0,1,6,14
Ronald Roberts,Dominican Republic,5,101,14,32,.438,0,1,.000,14,31,.452,.438,7,8,.875,10,11,21,2,2,1,4,12,35
RR Pogoy,Philippines,5,91,8,24,.333,3,12,.250,5,12,.417,.396,1,2,.500,3,7,10,4,2,0,3,10,20
Rudy Fernandez,Spain,8,217,19,47,.404,15,36,.417,4,11,.364,.564,9,12,.750,6,23,29,24,13,3,7,14,62
Rudy Gobert,France,8,210,27,43,.628,0,0,NA,27,43,.628,.628,27,39,.692,18,55,73,14,5,15,9,25,81
Rui Hachimura,Japan,3,90,13,30,.433,0,4,.000,13,26,.500,.433,14,20,.700,4,13,17,7,5,0,4,8,40
Rui Zhao,China,5,117,10,30,.333,3,14,.214,7,16,.438,.383,7,9,.778,2,5,7,9,5,0,4,12,30
Ryusei Shinoyama,Japan,3,53,4,8,.500,2,5,.400,2,3,.667,.625,0,0,NA,1,5,6,5,1,0,8,6,10
Sadiel Rojas,Dominican Republic,5,101,11,23,.478,4,8,.500,7,15,.467,.565,0,0,NA,8,11,19,3,7,0,8,14,26
Sajjad Mashayekhi,Iran,5,99,8,23,.348,2,5,.400,6,18,.333,.391,5,9,.556,8,10,18,3,4,0,8,15,23
Salah Mejri,Tunisia,5,155,31,57,.544,7,19,.368,24,38,.632,.605,12,14,.857,13,38,51,12,5,16,11,14,81
Samad Nik Bahrami,Iran,5,137,19,50,.380,10,20,.500,9,30,.300,.480,15,18,.833,3,11,14,14,1,1,9,10,63
Sangjae Kang,South Korea,5,49,5,8,.625,2,4,.500,3,4,.750,.750,0,0,NA,1,7,8,0,0,0,3,3,12
Scottie Wilbekin,Turkey,4,86,14,29,.483,6,12,.500,8,17,.471,.586,7,8,.875,1,10,11,26,5,0,4,11,41
Sead Sehovic,Montenegro,5,30,2,9,.222,0,2,.000,2,7,.286,.222,3,5,.600,1,4,5,1,1,0,2,3,7
Seiya Ando,Japan,3,63,3,12,.250,1,4,.250,2,8,.250,.292,2,3,.667,1,3,4,4,2,0,3,2,9
Semen Antonov,Russia,5,67,10,23,.435,0,7,.000,10,16,.625,.435,10,14,.714,6,13,19,5,2,2,4,5,30
Semih Erden,Turkey,5,115,13,26,.500,0,0,NA,13,26,.500,.500,8,13,.615,5,14,19,4,4,3,14,21,34
Seounghyun Lee,South Korea,5,145,18,39,.462,5,16,.313,13,23,.565,.526,5,6,.833,5,19,24,7,1,2,10,7,46
Sergey Karasev,Russia,5,67,5,15,.333,3,9,.333,2,6,.333,.433,7,9,.778,1,5,6,6,5,0,6,7,20
Sergio Llull,Spain,8,193,31,87,.356,13,49,.265,18,38,.474,.431,9,11,.818,0,10,10,30,4,0,17,19,84
Sertac Sanli,Turkey,4,45,5,9,.556,0,0,NA,5,9,.556,.556,6,10,.600,0,9,9,0,3,0,2,8,16
Shea Ili,New Zealand,5,104,13,27,.481,3,6,.500,10,21,.476,.537,23,28,.821,3,12,15,25,3,3,6,13,52
Shuo Fang,China,5,108,14,35,.400,7,24,.292,7,11,.636,.500,4,4,1.000,1,7,8,8,6,0,6,10,39
Shuto Ando,Japan,4,30,2,13,.154,1,11,.091,1,2,.500,.192,0,0,NA,1,4,5,0,2,0,2,1,5
Souleyman Diabate,Ivory Coast,5,129,17,49,.347,7,19,.368,10,30,.333,.418,1,1,1.000,4,5,9,19,5,0,10,5,42
Stanley Okoye,Nigeria,5,63,9,19,.474,7,11,.636,2,8,.250,.658,1,2,.500,1,8,9,10,2,1,5,8,26
Stefan Bircevic,Serbia,6,52,10,22,.455,5,13,.385,5,9,.556,.568,4,8,.500,2,15,17,3,3,1,2,9,29
Stefan Jovic,Serbia,8,200,24,49,.490,7,22,.318,17,27,.630,.561,1,2,.500,7,24,31,43,8,2,16,21,56
Suad Sehovic,Montenegro,5,98,6,19,.316,6,18,.333,0,1,.000,.474,3,3,1.000,4,8,12,2,1,0,3,9,21
Sun Minghui,China,4,53,5,16,.313,1,6,.167,4,10,.400,.344,1,3,.333,2,2,4,11,4,0,2,6,12
Sunhyung Kim,South Korea,5,122,11,50,.220,4,19,.211,7,31,.226,.260,7,9,.778,5,10,15,19,4,0,7,7,33
Tai Webster,New Zealand,5,137,24,55,.436,4,21,.190,20,34,.588,.473,15,20,.750,1,19,20,24,2,0,20,18,67
Talib Zanna,Nigeria,4,32,2,8,.250,1,2,.500,1,6,.167,.313,2,4,.500,3,5,8,4,3,1,3,3,7
Tayavek Gallizzi,Argentina,6,34,2,8,.250,0,0,NA,2,8,.250,.250,6,6,1.000,3,3,6,0,3,1,4,15,10
Thanasis Antetokounmpo,Greece,5,62,12,22,.545,3,8,.375,9,14,.643,.614,3,6,.500,3,4,7,5,2,2,4,14,30
Thomas Abercrombie,New Zealand,5,137,16,36,.444,6,17,.353,10,19,.526,.528,10,14,.714,8,20,28,5,3,4,5,12,48
Thomas Scrubb,Canada,5,44,5,13,.385,3,6,.500,2,7,.286,.500,3,5,.600,3,5,8,7,0,0,1,7,16
Tiegbe Bamba,Ivory Coast,5,79,10,20,.500,4,8,.500,6,12,.500,.600,6,11,.545,4,3,7,2,1,0,4,9,30
Tohi Smith-Milner,New Zealand,5,64,10,20,.500,5,12,.417,5,8,.625,.625,1,2,.500,5,9,14,5,6,6,1,9,26
Tomas Satoransky,Czech Republic,8,265,42,92,.457,13,27,.481,29,65,.446,.527,27,30,.900,6,39,45,68,7,3,22,14,124
Tomas Vyoral,Czech Republic,6,10,0,2,.000,0,2,.000,0,0,NA,.000,0,0,NA,0,0,0,1,0,0,2,1,0
Troy Rosario,Philippines,5,98,6,21,.286,1,10,.100,5,11,.455,.310,1,2,.500,8,15,23,1,0,1,2,12,14
Vafessa Fofana,Ivory Coast,5,110,4,23,.174,1,10,.100,3,13,.231,.196,7,9,.778,4,9,13,12,6,3,18,13,16
Vander Joaquim,Angola,5,118,21,40,.525,5,8,.625,16,32,.500,.588,11,14,.786,5,20,25,2,4,4,9,16,58
Vangelis Mantzaris,Greece,2,16,1,1,1.000,1,1,1.000,0,0,NA,1.500,2,2,1.000,0,2,2,5,0,0,1,0,5
Vasilije Micic,Serbia,8,150,16,37,.432,3,15,.200,13,22,.591,.473,10,10,1.000,2,12,14,26,7,0,14,14,45
Victor Claver,Spain,8,209,27,48,.563,6,19,.316,21,29,.724,.625,8,10,.800,15,24,39,13,12,5,10,21,68
Victor Liz,Dominican Republic,5,132,20,52,.385,7,20,.350,13,32,.406,.452,18,22,.818,5,9,14,10,7,1,17,7,65
Vincent Poirier,France,7,102,14,25,.560,0,0,NA,14,25,.560,.560,10,12,.833,11,16,27,5,1,2,6,11,38
Vitaly Fridzon,Russia,5,115,13,33,.394,3,10,.300,10,23,.435,.439,4,7,.571,4,8,12,9,8,0,6,11,33
Vitor Benite,Brazil,5,91,13,36,.361,11,22,.500,2,14,.143,.514,11,15,.733,2,6,8,3,1,0,4,12,48
Vladimir Ivlev,Russia,5,75,9,15,.600,1,1,1.000,8,14,.571,.633,4,6,.667,4,9,13,2,3,0,3,14,23
Vladimir Lucic,Serbia,8,174,16,34,.471,4,14,.286,12,20,.600,.529,21,24,.875,7,17,24,7,6,2,2,22,57
Vojtech Hruban,Czech Republic,8,227,37,80,.463,12,37,.324,25,43,.581,.538,5,5,1.000,12,24,36,16,6,2,12,21,91
Windi Graterol,Venezuela,4,34,3,9,.333,0,2,.000,3,7,.429,.333,0,0,NA,9,6,15,2,0,1,1,8,6
Xane D'Almeida,Senegal,5,161,13,35,.371,3,13,.231,10,22,.455,.414,4,5,.800,1,15,16,27,3,1,14,8,33
Xavi Rabaseda,Spain,4,17,0,2,.000,0,1,.000,0,1,.000,.000,0,0,NA,1,1,2,2,1,0,3,3,0
Xiaochuan Di,China,5,103,12,19,.632,0,3,.000,12,16,.750,.632,2,3,.667,6,10,16,1,3,1,4,9,26
Yago Mateus Dos Santos,Brazil,2,17,1,7,.143,0,5,.000,1,2,.500,.143,3,3,1.000,1,0,1,4,1,0,2,1,5
Yanick Moreira,Angola,5,136,26,48,.542,0,0,NA,26,48,.542,.542,8,11,.727,16,27,43,3,5,1,8,17,60
Ioannis Bourousis,Greece,5,84,8,20,.400,4,11,.364,4,9,.444,.500,4,4,1.000,5,14,19,5,3,0,5,11,24
Yigit Arslan,Turkey,3,17,1,3,.333,0,2,.000,1,1,1.000,.333,0,0,NA,1,2,3,1,0,0,1,2,2
Yousef Abuwazaneh,Jordan,5,60,3,12,.250,0,0,NA,3,12,.250,.250,1,4,.250,7,3,10,1,3,0,3,7,7
Youssou Ndoye,Senegal,5,126,24,48,.500,1,6,.167,23,42,.548,.510,10,12,.833,10,21,31,2,2,7,8,12,59
Yudai Baba,Japan,5,128,17,45,.378,4,13,.308,13,32,.406,.422,8,13,.615,2,11,13,15,7,0,8,11,46
Yuta Watanabe,Japan,5,162,25,56,.446,2,13,.154,23,43,.535,.464,26,28,.929,5,23,28,8,4,2,6,9,78
Zaid Abbas,Jordan,5,122,14,40,.350,2,10,.200,12,30,.400,.375,1,5,.200,9,16,25,8,1,0,15,17,31
Zhao Jiwei,China,5,116,6,20,.300,4,13,.308,2,7,.286,.400,7,8,.875,0,8,8,14,7,0,4,8,23
Zhelin Wang,China,5,103,14,28,.500,0,0,NA,14,28,.500,.500,12,17,.706,7,18,25,1,3,3,5,17,40
Zhou Qi,China,5,134,18,34,.529,3,10,.300,15,24,.625,.574,6,15,.400,6,32,38,6,4,7,9,16,45
Ziyed Chennoufi,Tunisia,5,56,3,14,.214,1,5,.200,2,9,.222,.250,1,2,.500,2,0,2,3,2,0,2,8,8
