player,team,games,minutes_played,field_goals,field_goal_attempts,field_goal_percentage,three_point_field_goals,three_point_field_goal_attempts,three_point_field_goal_percentage,two_point_field_goals,two_point_field_goal_attempts,two_point_field_goal_percentage,effective_field_goal_percentage,free_throws,free_throws_attempts,free_throws_percentage,offensive_rebounds,defensive_rebounds,total_rebounds,assists,steals,blocks,turnovers,personal_fouls,points
Aaron Cel,Poland,4,86,14,32,.438,5,15,.333,9,17,.529,.516,0,0,NA,5,12,17,6,0,0,5,8,33
Aaron Geramipoor,Iran,4,68,18,26,.692,0,0,NA,18,26,.692,.692,4,7,.571,8,19,27,3,3,1,6,10,40
Abudurexiti Abudushalamu,China,3,10,0,1,.000,0,1,.000,0,0,NA,.000,0,0,NA,1,1,2,0,0,0,2,3,0
Adam Hrycaniuk,Poland,4,89,10,20,.500,0,0,NA,10,20,.500,.500,6,9,.667,10,12,22,9,3,1,4,9,26
Adam Waczynski,Poland,4,131,15,33,.455,6,17,.353,9,16,.563,.545,15,17,.882,1,9,10,13,2,1,10,11,51
Agustin Caffaro,Argentina,2,6,3,3,1.000,0,0,NA,3,3,1.000,1.000,2,3,.667,1,2,3,0,0,1,1,0,8
Ahmed Hamarsha,Jordan,3,56,4,9,.444,3,6,.500,1,3,.333,.611,0,0,NA,1,6,7,2,2,0,0,5,11
Ahmed Obeid,Jordan,2,6,1,1,1.000,0,0,NA,1,1,1.000,1.000,0,0,NA,0,0,0,0,1,0,0,2,2
Ahmet Duverioglu,Jordan,3,99,23,36,.639,0,0,NA,23,36,.639,.639,11,18,.611,8,16,24,4,2,1,3,7,57
Ahmet Tuncer,Turkey,3,42,4,10,.400,1,5,.200,3,5,.600,.450,0,0,NA,1,4,5,13,0,0,1,3,9
Ailun Guo,China,4,92,17,45,.378,3,14,.214,14,31,.452,.411,3,6,.500,3,2,5,17,5,0,4,10,40
A.J. Slaughter,Poland,4,123,15,43,.349,6,23,.261,9,20,.450,.419,8,10,.800,2,8,10,14,2,1,9,7,44
Al-Farouq Aminu,Nigeria,4,85,12,25,.480,2,6,.333,10,19,.526,.520,9,13,.692,4,21,25,12,5,4,6,7,35
Aleksa Popovic,Montenegro,3,20,2,5,.400,0,1,.000,2,4,.500,.400,1,2,.500,0,1,1,2,0,0,1,3,5
Alessandro Gentile,Italy,4,76,8,25,.320,3,4,.750,5,21,.238,.380,11,18,.611,3,8,11,7,1,0,6,6,30
Alex Franklin,Puerto Rico,4,54,2,8,.250,0,2,.000,2,6,.333,.250,0,0,NA,2,6,8,3,1,0,3,8,4
Alex Garcia,Brazil,3,68,14,27,.519,3,8,.375,11,19,.579,.574,7,9,.778,2,6,8,11,4,0,5,6,38
Alex Pledger,New Zealand,3,14,2,4,.500,0,0,NA,2,4,.500,.500,0,0,NA,2,3,5,0,0,0,0,0,4
Amath M'Baye,France,3,61,13,19,.684,8,11,.727,5,8,.625,.895,1,2,.500,1,4,5,2,0,1,2,9,35
Amedeo Della Valle,Italy,4,46,10,24,.417,5,15,.333,5,9,.556,.521,6,6,1.000,1,5,6,4,2,0,4,3,31
Amedeo Tessitori,Italy,4,30,8,14,.571,0,1,.000,8,13,.615,.571,4,6,.667,4,6,10,2,0,1,2,6,20
Amin Abu Hawwas,Jordan,2,7,1,3,.333,0,0,NA,1,3,.333,.333,0,0,NA,1,0,1,0,0,0,0,1,2
Anderson Varejao,Brazil,3,63,13,23,.565,0,0,NA,13,23,.565,.565,8,9,.889,1,21,22,4,1,0,0,5,34
Andray Blatche,Philippines,4,133,26,63,.413,7,26,.269,19,37,.514,.468,8,12,.667,8,29,37,12,10,2,19,13,67
Andreas Obst,Germany,2,13,2,4,.500,2,3,.667,0,1,.000,.750,0,0,NA,0,0,0,3,0,0,0,1,6
Andrei Sopin,Russia,3,22,4,7,.571,1,4,.250,3,3,1.000,.643,0,0,NA,0,1,1,4,1,0,2,3,9
Andrew Albicy,France,3,57,3,7,.429,2,4,.500,1,3,.333,.571,1,2,.500,0,2,2,12,5,0,3,7,9
Andrew Bogut,Australia,3,51,11,13,.846,0,0,NA,11,13,.846,.846,0,2,.000,2,15,17,4,2,1,3,9,22
Andrew Nembhard,Canada,3,15,1,2,.500,1,1,1.000,0,1,.000,.750,2,2,1.000,0,2,2,3,0,0,3,3,5
Andrey Vorontsevich,Russia,4,112,18,37,.486,5,17,.294,13,20,.650,.554,6,7,.857,6,20,26,9,4,2,4,9,47
Andrey Zubkov,Russia,4,93,17,35,.486,2,9,.222,15,26,.577,.514,7,7,1.000,4,14,18,10,1,5,9,11,43
Angel Rodriguez,Puerto Rico,4,62,4,22,.182,2,10,.200,2,12,.167,.227,10,11,.909,2,8,10,7,4,0,9,9,20
Anthony Perez,Venezuela,2,17,0,5,.000,0,3,.000,0,2,.000,.000,1,2,.500,1,1,2,0,0,0,1,3,1
Ariel Filloy,Italy,2,21,3,7,.429,1,4,.250,2,3,.667,.500,0,0,NA,0,3,3,4,1,0,4,1,7
Arman Zangeneh,Iran,4,45,4,11,.364,2,5,.400,2,6,.333,.455,1,2,.500,0,5,5,1,2,2,3,7,11
Arnas Butkevicius,Lithuania,3,34,4,6,.667,0,1,.000,4,5,.800,.667,1,2,.500,3,5,8,1,0,0,2,6,9
Aron Baynes,Australia,3,67,17,31,.548,3,7,.429,14,24,.583,.597,6,7,.857,8,12,20,5,0,2,3,5,43
Augusto Lima,Brazil,2,8,0,1,.000,0,0,NA,0,1,.000,.000,0,0,NA,0,1,1,0,0,0,1,4,0
Avi Koki Schafer,Japan,1,6,0,2,.000,0,0,NA,0,2,.000,.000,0,0,NA,0,0,0,0,1,0,0,0,0
Awudu Abass,Italy,3,46,6,12,.500,4,9,.444,2,3,.667,.667,2,2,1.000,1,3,4,2,1,0,3,4,18
Axel Toupane,France,3,43,6,9,.667,4,6,.667,2,3,.667,.889,1,2,.500,0,4,4,2,1,1,2,5,17
Babacar Toure,Senegal,3,51,10,18,.556,1,2,.500,9,16,.563,.583,1,1,1.000,6,1,7,0,0,0,3,5,22
Bali Coulibaly,Ivory Coast,1,1,0,0,NA,0,0,NA,0,0,NA,NA,0,0,NA,0,0,0,0,0,0,0,0,0
Baru Adjehi,Ivory Coast,3,31,4,6,.667,0,0,NA,4,6,.667,.667,1,2,.500,2,4,6,3,0,1,1,6,9
Behnam Yakhchali,Iran,4,148,17,34,.500,9,21,.429,8,13,.615,.632,3,3,1.000,2,7,9,10,6,1,6,3,46
Ben Uzoh,Nigeria,4,76,15,26,.577,0,3,.000,15,23,.652,.577,0,2,.000,3,5,8,7,2,0,6,7,30
Blake Schilb,Czech Republic,3,67,12,21,.571,9,13,.692,3,8,.375,.786,0,0,NA,0,6,6,9,3,0,2,2,33
Boban Marjanovic,Serbia,4,55,19,23,.826,0,1,.000,19,22,.864,.826,5,9,.556,6,10,16,4,1,3,7,4,43
Bogdan Bogdanovic,Serbia,4,94,25,47,.532,16,28,.571,9,19,.474,.702,11,15,.733,4,7,11,18,7,0,5,5,77
Bojan Dubljevic,Montenegro,3,79,7,21,.333,4,14,.286,3,7,.429,.429,10,14,.714,9,12,21,9,6,0,9,9,28
Brady Heslip,Canada,3,35,6,14,.429,4,10,.400,2,4,.500,.571,3,3,1.000,1,2,3,1,0,0,0,2,19
Brook Lopez,United States,3,35,5,14,.357,2,10,.200,3,4,.750,.429,1,3,.333,2,6,8,2,0,5,2,3,13
Bruno Caboclo,Brazil,3,80,6,19,.316,4,10,.400,2,9,.222,.421,1,2,.500,2,18,20,4,3,5,4,8,17
Bryan Pamba,Ivory Coast,4,81,4,19,.211,1,7,.143,3,12,.250,.237,1,2,.500,5,12,17,11,4,0,6,6,10
Cameron Gliddon,Australia,1,1,0,0,NA,0,0,NA,0,0,NA,NA,0,0,NA,0,0,0,0,0,0,0,0,0
Carlos Morais,Angola,4,126,21,49,.429,6,16,.375,15,33,.455,.490,5,8,.625,2,8,10,8,4,1,11,6,53
Cedi Osman,Turkey,3,93,18,40,.450,4,16,.250,14,24,.583,.500,11,14,.786,2,4,6,8,3,2,3,9,51
Chan Hee Park,South Korea,4,53,4,8,.500,0,2,.000,4,6,.667,.500,4,10,.400,2,8,10,12,5,0,7,4,12
Chimezie Metu,Nigeria,4,74,11,23,.478,4,7,.571,7,16,.438,.565,8,8,1.000,5,17,22,6,2,5,7,6,34
Chris Brady,Puerto Rico,2,14,0,3,.000,0,1,.000,0,2,.000,.000,2,2,1.000,1,3,4,0,2,0,0,4,2
Chris Goulding,Australia,3,51,9,13,.692,4,7,.571,5,6,.833,.846,2,3,.667,0,1,1,2,1,0,1,11,24
Cj Perez,Philippines,4,82,22,41,.537,5,14,.357,17,27,.630,.598,5,6,.833,6,6,12,11,3,0,13,8,54
Conor Morgan,Canada,2,20,2,7,.286,1,3,.333,1,4,.250,.357,0,0,NA,3,2,5,1,1,1,5,2,5
Corey Webster,New Zealand,3,91,25,49,.510,18,32,.563,7,17,.412,.694,7,8,.875,1,14,15,17,3,0,5,7,75
Cory Joseph,Canada,3,88,21,43,.488,4,8,.500,17,35,.486,.535,9,10,.900,3,7,10,10,4,0,5,8,55
Cristiano Felicio,Brazil,3,53,10,16,.625,0,0,NA,10,16,.625,.625,3,4,.750,13,9,22,5,1,1,3,5,23
Daesung Lee,South Korea,3,47,9,25,.360,8,18,.444,1,7,.143,.520,4,5,.800,2,4,6,4,4,0,6,10,30
Dagoberto Pena,Dominican Republic,3,17,2,5,.400,2,4,.500,0,1,.000,.600,2,2,1.000,1,0,1,1,0,0,1,3,8
Daiki Tanaka,Japan,3,64,8,19,.421,5,11,.455,3,8,.375,.553,0,1,.000,0,2,2,3,1,0,4,1,21
Damian Kulig,Poland,4,80,8,22,.364,1,8,.125,7,14,.500,.386,15,19,.789,7,14,21,1,2,5,4,9,32
Daniel Hackett,Italy,4,99,10,27,.370,6,18,.333,4,9,.444,.481,10,14,.714,1,19,20,10,6,0,9,8,36
Daniel Theis,Germany,3,52,10,24,.417,1,5,.200,9,19,.474,.438,1,1,1.000,6,14,20,1,6,0,1,11,22
Danilo Barthel,Germany,3,57,10,15,.667,1,5,.200,9,10,.900,.700,3,4,.750,1,13,14,1,3,2,2,3,24
Danilo Gallinari,Italy,4,110,21,35,.600,9,17,.529,12,18,.667,.729,13,19,.684,5,17,22,9,4,1,1,5,64
Dar Tucker,Jordan,3,104,17,48,.354,6,22,.273,11,26,.423,.417,18,22,.818,1,10,11,4,3,1,12,7,58
David Barlow,Australia,2,0,0,0,NA,0,0,NA,0,0,NA,NA,0,0,NA,0,0,0,0,0,0,0,0,0
David Huertas,Puerto Rico,4,106,24,47,.511,9,18,.500,15,29,.517,.606,3,4,.750,0,7,7,9,1,1,6,6,60
Dennis Schroder,Germany,3,95,16,43,.372,5,12,.417,11,31,.355,.430,16,21,.762,1,6,7,26,4,0,10,4,53
Deon Thompson,Ivory Coast,4,133,22,44,.500,7,14,.500,15,30,.500,.580,8,10,.800,9,19,28,7,4,2,7,7,59
Derek Needham,Montenegro,3,67,10,24,.417,7,19,.368,3,5,.600,.563,0,0,NA,0,2,2,14,3,1,9,9,27
Derrick White,United States,3,46,6,15,.400,1,5,.200,5,10,.500,.433,3,5,.600,1,5,6,9,5,0,6,5,16
Devon Collier,Puerto Rico,4,84,10,20,.500,0,1,.000,10,19,.526,.500,2,2,1.000,5,8,13,1,1,1,3,11,22
Didi,Brazil,3,32,3,9,.333,2,4,.500,1,5,.200,.444,3,4,.750,1,7,8,2,4,1,0,3,11
Dino Radoncic,Montenegro,3,39,4,7,.571,1,3,.333,3,4,.750,.643,0,0,NA,5,7,12,1,1,0,4,4,9
Divaldo Mbunga,Angola,3,20,1,4,.250,0,1,.000,1,3,.333,.250,0,0,NA,0,1,1,2,0,1,1,2,2
Djibril Thiam,Senegal,2,26,3,13,.231,0,5,.000,3,8,.375,.231,1,2,.500,2,3,5,2,0,0,5,2,7
Dogus Balbay,Turkey,3,48,1,8,.125,0,4,.000,1,4,.250,.125,0,2,.000,4,8,12,14,2,1,0,5,2
Domantas Sabonis,Lithuania,3,69,12,22,.545,0,1,.000,12,21,.571,.545,11,15,.733,10,9,19,11,1,2,0,8,35
Dominik Olejniczak,Poland,2,6,2,3,.667,0,0,NA,2,3,.667,.667,0,0,NA,1,2,3,1,0,0,1,1,4
Donovan Mitchell,United States,3,77,14,31,.452,7,18,.389,7,13,.538,.565,0,0,NA,1,8,9,12,4,1,1,6,35
Dwight Lewis,Venezuela,4,68,14,28,.500,4,9,.444,10,19,.526,.571,2,2,1.000,2,3,5,4,2,1,2,5,34
Edgaras Ulanovas,Lithuania,3,68,9,21,.429,0,6,.000,9,15,.600,.429,5,6,.833,4,8,12,7,0,0,0,5,23
Eduardo Mingas,Angola,2,21,2,5,.400,0,0,NA,2,5,.400,.400,0,0,NA,2,3,5,1,1,0,2,3,4
Ekpe Udoh,Nigeria,4,75,9,15,.600,0,0,NA,9,15,.600,.600,2,4,.500,6,10,16,4,3,5,2,5,20
Eloy Vargas,Dominican Republic,3,55,12,24,.500,0,2,.000,12,22,.545,.500,7,9,.778,7,10,17,1,0,2,2,11,31
Ersan Ilyasova,Turkey,3,98,16,44,.364,6,18,.333,10,26,.385,.432,10,11,.909,5,23,28,6,5,3,5,10,48
Ethan Rusbatch,New Zealand,3,29,4,9,.444,3,7,.429,1,2,.500,.611,1,2,.500,1,2,3,0,1,0,1,6,12
Eulis Baez,Dominican Republic,3,70,6,21,.286,2,13,.154,4,8,.500,.333,3,4,.750,3,10,13,5,3,0,2,5,17
Evan Fournier,France,3,69,17,38,.447,4,8,.500,13,30,.433,.500,11,15,.733,1,12,13,11,5,1,5,5,49
Evegeny Valiev,Russia,3,19,1,4,.250,0,0,NA,1,4,.250,.250,0,0,NA,3,1,4,2,1,0,0,2,2
Evgeny Baburin,Russia,4,34,3,7,.429,3,7,.429,0,0,NA,.643,0,0,NA,4,2,6,5,2,0,1,12,9
Facu Campazzo,Argentina,4,113,17,36,.472,10,22,.455,7,14,.500,.611,14,17,.824,3,11,14,30,7,0,9,9,58
Fadi Ibrahim,Jordan,3,64,9,20,.450,6,10,.600,3,10,.300,.600,0,2,.000,0,6,6,5,1,1,9,7,24
Finn Delaney,New Zealand,3,40,1,8,.125,0,3,.000,1,5,.200,.125,2,2,1.000,2,5,7,0,0,0,4,7,4
Frank Ntilikina,France,3,60,8,17,.471,6,11,.545,2,6,.333,.647,6,6,1.000,1,6,7,9,6,1,4,4,28
Frejus Zerbo,Ivory Coast,4,45,5,10,.500,0,0,NA,5,10,.500,.500,0,1,.000,3,9,12,3,2,0,3,9,10
Furkan Korkmaz,Turkey,3,80,16,33,.485,6,14,.429,10,19,.526,.576,4,5,.800,4,7,11,5,5,0,4,6,42
Gabe Norwood,Philippines,4,60,0,7,.000,0,6,.000,0,1,.000,.000,0,0,NA,1,4,5,3,1,0,1,8,0
Gabe Vincent,Nigeria,4,75,16,34,.471,10,26,.385,6,8,.750,.618,4,6,.667,1,4,5,1,7,0,4,11,46
Gabriel Deck,Argentina,4,94,17,37,.459,4,9,.444,13,28,.464,.514,14,17,.824,4,7,11,4,3,1,2,8,52
Gary Browne,Puerto Rico,4,98,13,40,.325,2,12,.167,11,28,.393,.350,4,4,1.000,2,10,12,20,5,0,6,8,32
Gelvis Solano,Dominican Republic,3,63,7,20,.350,3,11,.273,4,9,.444,.425,2,6,.333,1,7,8,18,4,0,9,5,19
Georgios Papagiannis,Greece,2,34,9,14,.643,0,0,NA,9,14,.643,.643,1,1,1.000,3,8,11,1,1,4,0,5,19
Gerson Domingos,Angola,3,80,4,24,.167,1,11,.091,3,13,.231,.188,7,8,.875,1,6,7,4,1,0,10,5,16
Gerson Lukeny Goncalves,Angola,4,51,5,17,.294,1,7,.143,4,10,.400,.324,1,2,.500,0,3,3,4,2,1,6,5,12
Gian Clavell,Puerto Rico,4,77,9,31,.290,3,16,.188,6,15,.400,.339,9,12,.750,5,11,16,6,2,0,2,4,30
Giannis Antetokounmpo,Greece,3,75,13,26,.500,1,6,.167,12,20,.600,.519,20,24,.833,3,19,22,8,7,2,7,11,47
Giannoulis Larentzakis,Greece,2,23,4,6,.667,2,4,.500,2,2,1.000,.833,6,7,.857,0,2,2,1,0,0,2,4,16
Giorgos Printezis,Greece,3,68,16,27,.593,7,10,.700,9,17,.529,.722,10,13,.769,1,7,8,4,2,0,3,2,49
Gregory Vargas,Venezuela,4,82,9,25,.360,1,8,.125,8,17,.471,.380,10,12,.833,3,7,10,10,1,0,12,10,29
Grigory Motovilov,Russia,4,49,4,13,.308,1,6,.167,3,7,.429,.346,2,4,.500,0,2,2,5,0,0,8,8,11
Willy Hernangomez,Spain,4,48,8,14,.571,0,0,NA,8,14,.571,.571,4,7,.571,2,14,16,7,1,2,2,7,20
Guna Ra,South Korea,4,141,33,73,.452,3,7,.429,30,66,.455,.473,20,29,.690,22,26,48,7,6,3,10,6,89
Guy Edi,Ivory Coast,4,98,8,28,.286,4,15,.267,4,13,.308,.357,6,8,.750,3,8,11,5,1,0,6,6,26
Hamady N'Diaye,Senegal,3,36,2,2,1.000,0,0,NA,2,2,1.000,1.000,1,2,.500,2,2,4,1,1,4,1,5,5
Hamed Haddadi,Iran,4,126,20,47,.426,3,5,.600,17,42,.405,.457,11,17,.647,10,37,47,20,2,4,19,11,54
Hamed Hosseinzadeh,Iran,2,12,0,2,.000,0,1,.000,0,1,.000,.000,0,0,NA,0,1,1,2,0,0,1,0,0
Harrison Barnes,United States,3,67,13,27,.481,4,13,.308,9,14,.643,.556,8,8,1.000,6,9,15,1,3,0,6,8,38
Heejong Yang,South Korea,3,33,1,5,.200,1,4,.250,0,1,.000,.300,0,0,NA,1,5,6,2,2,0,1,6,3
Heissler Guillent,Venezuela,4,117,23,50,.460,11,25,.440,12,25,.480,.570,1,3,.333,3,6,9,26,5,0,7,4,58
Hoon Heo,South Korea,4,19,1,7,.143,0,2,.000,1,5,.200,.143,3,4,.750,1,0,1,1,1,0,1,0,5
Hyogeun Jeong,South Korea,4,59,4,18,.222,2,10,.200,2,8,.250,.278,2,2,1.000,1,8,9,1,1,1,1,4,12
Ibrahima Fall Faye,Senegal,1,21,3,8,.375,1,1,1.000,2,7,.286,.438,1,2,.500,2,2,4,0,0,0,1,2,8
Ike Diogu,Nigeria,4,70,11,31,.355,3,13,.231,8,18,.444,.403,5,7,.714,6,20,26,4,0,2,5,7,30
Ike Iroegbu,Nigeria,4,91,11,31,.355,2,10,.200,9,21,.429,.387,9,11,.818,0,9,9,14,4,0,7,10,33
Ioannis Papapetrou,Greece,3,72,10,19,.526,5,12,.417,5,7,.714,.658,2,2,1.000,1,7,8,1,3,1,3,4,27
Isaac Fotu,New Zealand,3,64,19,26,.731,0,2,.000,19,24,.792,.731,14,20,.700,5,10,15,4,0,0,5,9,52
Isaiah Pineiro,Puerto Rico,4,60,9,19,.474,1,3,.333,8,16,.500,.500,5,6,.833,4,7,11,1,3,0,2,8,24
Ismet Akpinar,Germany,3,50,5,13,.385,2,5,.400,3,8,.375,.462,0,0,NA,2,4,6,0,1,0,1,6,12
Jakub Sirina,Czech Republic,2,8,0,1,.000,0,0,NA,0,1,.000,.000,0,0,NA,0,0,0,3,0,0,2,1,0
James Birsen,Turkey,3,32,4,6,.667,0,1,.000,4,5,.800,.667,0,0,NA,3,7,10,0,0,0,1,1,8
Japeth Aguilar,Philippines,4,91,9,24,.375,0,2,.000,9,22,.409,.375,1,2,.500,7,8,15,4,0,1,3,8,19
Jaromir Bohacik,Czech Republic,3,85,19,37,.514,8,18,.444,11,19,.579,.622,4,4,1.000,5,12,17,9,0,0,4,10,50
Javier Beiran,Spain,2,15,2,5,.400,0,3,.000,2,2,1.000,.400,0,0,NA,3,4,7,0,1,0,0,0,4
Javier Mojica,Puerto Rico,4,31,4,16,.250,0,4,.000,4,12,.333,.250,2,2,1.000,3,5,8,1,4,1,0,1,10
Jaylen Brown,United States,3,47,10,21,.476,2,7,.286,8,14,.571,.524,1,4,.250,3,8,11,2,2,1,2,3,23
Jayson Tatum,United States,2,49,7,22,.318,2,8,.250,5,14,.357,.364,5,6,.833,3,12,15,5,2,3,4,4,21
Jeff Brooks,Italy,4,71,9,15,.600,2,6,.333,7,9,.778,.667,2,3,.667,9,10,19,3,7,4,2,10,22
Jhornan Jose Zamora,Venezuela,4,80,9,31,.290,6,22,.273,3,9,.333,.387,2,3,.667,0,5,5,4,2,0,2,6,26
Jianlian Yi,China,4,113,21,46,.457,3,10,.300,18,36,.500,.489,17,27,.630,9,24,33,4,4,3,11,9,62
Quino Colom,Spain,3,24,3,4,.750,1,2,.500,2,2,1.000,.875,0,0,NA,0,2,2,6,1,0,1,2,7
Jock Landale,Australia,3,59,7,16,.438,3,9,.333,4,7,.571,.531,1,2,.500,3,9,12,3,0,1,6,4,18
Joe Harris,United States,3,60,11,18,.611,6,9,.667,5,9,.556,.778,2,2,1.000,4,10,14,2,2,0,1,6,30
Joe Ingles,Australia,3,97,10,22,.455,6,14,.429,4,8,.500,.591,6,7,.857,0,20,20,26,4,3,11,8,32
Johannes Thiemann,Germany,1,8,2,3,.667,0,0,NA,2,3,.667,.667,1,1,1.000,1,2,3,0,0,0,2,1,5
Johannes Voigtmann,Germany,3,61,12,16,.750,7,11,.636,5,5,1.000,.969,4,5,.800,1,8,9,7,2,2,8,8,35
Johnkyu Kim,South Korea,3,25,2,11,.182,0,0,NA,2,11,.182,.182,0,0,NA,2,3,5,1,1,0,3,5,4
Joji Takeuchi,Japan,3,46,2,8,.250,1,2,.500,1,6,.167,.313,3,4,.750,1,3,4,2,0,0,3,2,8
Jonas Maciulis,Lithuania,3,51,6,17,.353,4,10,.400,2,7,.286,.471,2,2,1.000,1,10,11,5,3,0,2,8,18
Jonas Valanciunas,Lithuania,3,62,13,18,.722,0,0,NA,13,18,.722,.722,7,9,.778,8,18,26,3,3,3,4,8,33
Jordan Dasuqi,Jordan,3,35,0,3,.000,0,3,.000,0,0,NA,.000,0,0,NA,0,1,1,0,0,0,1,2,0
Jordan Ngatai,New Zealand,2,13,0,1,.000,0,0,NA,0,1,.000,.000,0,0,NA,0,0,0,0,0,0,1,2,0
Jordan Nwora,Nigeria,2,51,8,24,.333,3,11,.273,5,13,.385,.396,3,4,.750,0,7,7,4,6,0,4,4,22
Jorge Diaz,Puerto Rico,4,59,8,18,.444,2,4,.500,6,14,.429,.500,0,0,NA,3,9,12,2,1,3,4,9,18
Jose Antonio,Angola,4,78,7,20,.350,5,13,.385,2,7,.286,.475,4,6,.667,2,5,7,3,5,1,4,8,23
Jose Vargas,Venezuela,4,71,5,17,.294,3,10,.300,2,7,.286,.382,0,2,.000,2,7,9,4,3,0,5,11,13
Josh Okogie,Nigeria,4,92,13,33,.394,8,19,.421,5,14,.357,.515,10,12,.833,2,11,13,19,9,4,9,6,44
Juan Hernangomez,Spain,4,93,18,31,.581,4,11,.364,14,20,.700,.645,8,12,.667,8,19,27,2,3,1,3,8,48
Juan Jose Garcia,Dominican Republic,3,20,1,6,.167,1,5,.200,0,1,.000,.250,0,2,.000,1,3,4,1,1,1,1,2,3
Juan Miguel Suero,Dominican Republic,2,17,0,1,.000,0,0,NA,0,1,.000,.000,2,2,1.000,1,2,3,0,0,0,1,2,2
June Mar Fajardo,Philippines,4,65,7,14,.500,0,0,NA,7,14,.500,.500,11,14,.786,8,13,21,3,3,1,5,6,25
Junfei Ren,China,2,16,1,2,.500,0,0,NA,1,2,.500,.500,0,0,NA,0,3,3,1,0,0,1,2,2
Junghyun Lee,South Korea,4,104,12,35,.343,9,28,.321,3,7,.429,.471,7,10,.700,1,15,16,16,1,1,11,13,40
Junyong Choi,South Korea,4,66,4,13,.308,3,9,.333,1,4,.250,.423,3,6,.500,3,8,11,3,0,3,4,9,14
Kamil Laczynski,Poland,1,1,0,2,.000,0,2,.000,0,0,NA,.000,0,0,NA,0,0,0,1,0,0,0,0,0
Karol Gruszecki,Poland,3,18,1,3,.333,1,2,.500,0,1,.000,.500,0,0,NA,0,1,1,0,1,0,0,1,3
Kaza Kajami-Keane,Canada,2,3,1,1,1.000,1,1,1.000,0,0,NA,1.500,0,0,NA,0,0,0,0,0,0,1,1,3
Kelanbaike Makan,China,1,0,0,0,NA,0,0,NA,0,0,NA,NA,0,0,NA,0,0,0,0,0,0,0,0,0
Kemba Walker,United States,3,71,16,33,.485,7,19,.368,9,14,.643,.591,3,5,.600,3,6,9,19,4,1,3,5,42
Kevin Pangos,Canada,3,90,12,32,.375,5,14,.357,7,18,.389,.453,1,2,.500,2,6,8,21,5,0,4,6,30
Khem Birch,Canada,3,81,13,27,.481,0,4,.000,13,23,.565,.481,10,16,.625,11,8,19,3,5,5,7,8,36
Khris Middleton,United States,3,57,11,23,.478,5,12,.417,6,11,.545,.587,5,6,.833,4,8,12,8,3,0,1,5,32
Kiefer Ravena,Philippines,4,69,5,27,.185,3,16,.188,2,11,.182,.241,8,11,.727,2,5,7,6,2,0,5,7,21
Kostas Papanikolaou,Greece,3,75,3,14,.214,1,6,.167,2,8,.250,.250,7,7,1.000,5,9,14,6,2,4,0,4,14
Kostas Sloukas,Greece,3,68,7,17,.412,1,8,.125,6,9,.667,.441,5,6,.833,1,7,8,20,1,0,2,6,20
Kosuke Takeuchi,Japan,1,18,0,2,.000,0,0,NA,0,2,.000,.000,3,4,.750,3,3,6,1,2,0,0,1,3
Kyle Wiltjer,Canada,3,69,11,24,.458,5,13,.385,6,11,.545,.563,8,9,.889,3,5,8,2,2,0,2,4,35
Lamine Sambe,Senegal,3,77,8,31,.258,3,18,.167,5,13,.385,.306,0,0,NA,0,0,0,6,2,0,5,8,19
Leandro Barbosa,Brazil,3,67,14,33,.424,3,6,.500,11,27,.407,.470,12,15,.800,0,7,7,9,2,0,2,4,43
Leandro Jacques Conceicao,Angola,3,55,5,14,.357,2,8,.250,3,6,.500,.429,0,0,NA,0,4,4,3,0,0,3,7,12
Leonel Paulo,Angola,4,86,12,19,.632,1,3,.333,11,16,.688,.658,10,14,.714,3,12,15,8,3,2,5,10,35
Louis Cyrille Jean Benoit A Sie,Ivory Coast,1,1,0,0,NA,0,0,NA,0,0,NA,NA,0,0,NA,1,0,1,0,0,0,0,0,0
Louis Labeyrie,France,2,9,2,2,1.000,0,0,NA,2,2,1.000,1.000,0,0,NA,0,1,1,0,0,1,1,3,4
Luca Vildoza,Argentina,4,77,6,19,.316,3,13,.231,3,6,.500,.395,5,6,.833,0,5,5,10,8,1,6,6,20
Luca Vitali,Italy,4,34,1,5,.200,0,2,.000,1,3,.333,.200,0,0,NA,0,0,0,6,0,1,5,5,2
Lucio Redivo,Argentina,2,10,0,6,.000,0,4,.000,0,2,.000,.000,0,0,NA,0,1,1,2,0,0,1,0,0
Luigi Datome,Italy,4,90,16,27,.593,6,12,.500,10,15,.667,.704,4,5,.800,1,10,11,8,3,3,5,11,42
Luis Bethelmy,Venezuela,3,22,5,7,.714,4,5,.800,1,2,.500,1.000,0,1,.000,1,5,6,1,0,0,1,2,14
Luis Montero,Dominican Republic,3,62,7,20,.350,4,10,.400,3,10,.300,.450,1,4,.250,4,4,8,2,6,3,1,7,19
Luis Scola,Argentina,4,105,21,49,.429,5,12,.417,16,37,.432,.480,19,23,.826,9,24,33,5,1,2,8,11,66
Lukas Lekavicius,Lithuania,3,50,12,22,.545,0,5,.000,12,17,.706,.545,12,13,.923,0,3,3,7,5,0,4,8,36
Lukas Palyza,Czech Republic,1,4,1,1,1.000,1,1,1.000,0,0,NA,1.500,0,0,NA,1,1,2,0,0,0,0,1,3
Lukasz Koszarek,Poland,4,56,5,12,.417,4,10,.400,1,2,.500,.583,0,0,NA,1,1,2,13,2,0,2,5,14
Mahmoud Abdeen,Jordan,3,52,7,13,.538,2,6,.333,5,7,.714,.615,0,0,NA,1,3,4,5,2,0,5,7,16
Makhtar Gueye,Senegal,1,3,0,2,.000,0,1,.000,0,1,.000,.000,0,0,NA,0,0,0,0,0,0,0,0,0
Makoto Hiejima,Japan,3,50,6,14,.429,1,4,.250,5,10,.500,.464,1,2,.500,0,3,3,2,2,0,6,6,14
Makram Ben Romdhane,Tunisia,4,104,18,38,.474,2,10,.200,16,28,.571,.500,7,14,.500,15,13,28,12,8,2,7,13,45
Mantas Kalnietis,Lithuania,3,69,14,26,.538,5,11,.455,9,15,.600,.635,0,0,NA,1,7,8,16,3,0,5,3,33
Maodo Lo,Germany,3,67,8,13,.615,3,6,.500,5,7,.714,.731,1,3,.333,1,7,8,10,3,0,1,8,20
Marc Gasol,Spain,4,108,17,41,.415,3,11,.273,14,30,.467,.451,10,14,.714,0,23,23,9,5,4,5,7,47
Marcelo Huertas,Brazil,3,52,8,22,.364,1,6,.167,7,16,.438,.386,3,3,1.000,0,4,4,13,0,0,2,1,20
Marco Belinelli,Italy,4,105,17,43,.395,6,19,.316,11,24,.458,.465,8,13,.615,3,11,14,13,6,0,7,5,48
Marcos Delia,Argentina,4,100,13,21,.619,0,0,NA,13,21,.619,.619,6,13,.462,8,16,24,2,1,6,3,7,32
Marcus Smart,United States,2,32,3,7,.429,1,3,.333,2,4,.500,.500,2,4,.500,2,2,4,3,0,0,2,5,9
Marius Grigonis,Lithuania,3,69,15,32,.469,3,8,.375,12,24,.500,.516,6,6,1.000,1,6,7,5,3,0,4,3,39
Mark Barroca,Philippines,3,33,5,12,.417,1,5,.200,4,7,.571,.458,2,2,1.000,2,2,4,1,1,0,3,5,13
Marko Guduric,Serbia,4,67,9,21,.429,6,17,.353,3,4,.750,.571,7,8,.875,0,5,5,7,4,0,4,4,31
Marko Simonovic,Serbia,4,63,7,12,.583,3,6,.500,4,6,.667,.708,0,0,NA,1,6,7,2,2,1,2,5,17
Marko Todorovic,Montenegro,3,36,1,4,.250,0,1,.000,1,3,.333,.250,1,2,.500,0,3,3,1,4,2,2,8,3
Marquinhos Vieira,Brazil,3,55,14,23,.609,7,14,.500,7,9,.778,.761,5,6,.833,1,4,5,1,3,0,2,4,40
Martin Kriz,Czech Republic,3,36,3,10,.300,0,2,.000,3,8,.375,.300,0,0,NA,3,2,5,2,0,0,2,2,6
Martin Peterka,Czech Republic,3,22,3,5,.600,1,2,.500,2,3,.667,.700,0,0,NA,0,2,2,2,1,0,1,1,7
Mason Plumlee,United States,2,22,1,5,.200,0,0,NA,1,5,.200,.200,0,0,NA,3,5,8,0,0,1,2,0,2
Mateusz Ponitka,Poland,4,120,17,35,.486,2,6,.333,15,29,.517,.514,30,39,.769,2,25,27,7,6,6,7,7,66
Mathias Lessort,France,2,40,6,11,.545,0,0,NA,6,11,.545,.545,6,9,.667,3,4,7,1,0,1,1,3,18
Matthew Dellavedova,Australia,3,90,13,26,.500,8,18,.444,5,8,.625,.654,6,9,.667,4,13,17,17,1,0,8,6,40
Maurice Ndour,Senegal,3,91,11,33,.333,1,8,.125,10,25,.400,.348,7,9,.778,3,14,17,3,6,2,8,9,30
Maxi Kleber,Germany,3,62,9,21,.429,3,10,.300,6,11,.545,.500,3,3,1.000,2,4,6,2,2,7,3,3,24
Maximo Fjellerup,Argentina,3,26,2,2,1.000,0,0,NA,2,2,1.000,1.000,1,2,.500,0,8,8,2,3,0,0,3,5
Melih Mahmutoglu,Turkey,3,89,20,35,.571,9,18,.500,11,17,.647,.700,0,1,.000,2,3,5,0,3,0,4,1,49
Melvin Ejim,Canada,3,73,8,20,.400,1,10,.100,7,10,.700,.425,3,3,1.000,2,15,17,3,3,1,5,9,20
Michael Carrera,Venezuela,4,56,10,17,.588,0,3,.000,10,14,.714,.588,11,16,.688,8,7,15,4,2,1,5,9,31
Michael Eric,Nigeria,3,34,11,14,.786,0,0,NA,11,14,.786,.786,4,7,.571,6,7,13,2,2,3,4,5,26
Michael Roll,Tunisia,4,130,20,49,.408,7,20,.350,13,29,.448,.480,3,3,1.000,2,9,11,15,4,0,7,9,50
Michael Rostampour,Iran,4,59,5,9,.556,2,5,.400,3,4,.750,.667,5,8,.625,1,7,8,2,5,0,1,8,17
Michal Sokolowski,Poland,4,68,11,16,.688,2,3,.667,9,13,.692,.750,7,8,.875,5,8,13,3,3,1,3,9,31
Miguel Ruiz,Venezuela,4,91,10,16,.625,0,0,NA,10,16,.625,.625,1,1,1.000,12,19,31,2,5,0,3,13,21
Mikhail Kulagin,Russia,4,91,14,42,.333,10,26,.385,4,16,.250,.452,10,10,1.000,0,6,6,8,3,0,8,9,48
Milko Bjelica,Montenegro,3,47,11,28,.393,3,10,.300,8,18,.444,.446,2,2,1.000,2,3,5,0,1,1,0,6,27
Mindaugas Kuzminskas,Lithuania,3,46,8,17,.471,3,6,.500,5,11,.455,.559,4,7,.571,6,1,7,1,2,0,3,4,23
Miroslav Raduljica,Serbia,4,37,6,11,.545,0,0,NA,6,11,.545,.545,17,18,.944,1,7,8,7,1,0,7,10,29
Mitchell Creek,Australia,3,29,2,4,.500,0,1,.000,2,3,.667,.500,6,8,.750,3,5,8,2,1,0,0,4,10
Mohamed Abassi,Tunisia,1,10,0,1,.000,0,0,NA,0,1,.000,.000,1,2,.500,0,1,1,1,0,0,0,3,1
Mohamed Deba Kone,Ivory Coast,3,55,10,28,.357,0,3,.000,10,25,.400,.357,3,5,.600,6,5,11,3,3,0,2,6,23
Mohammad Hassanzadeh,Iran,3,30,6,12,.500,0,1,.000,6,11,.545,.500,1,3,.333,4,2,6,1,1,0,1,3,13
Mohammad Jamshidi,Iran,4,110,13,33,.394,1,8,.125,12,25,.480,.409,5,7,.714,2,8,10,13,1,0,6,8,32
Mohammad Shaher,Jordan,2,30,3,9,.333,0,0,NA,3,9,.333,.333,2,3,.667,3,2,5,2,2,1,4,4,8
Mokhtar Ghayaza,Tunisia,2,17,3,5,.600,0,0,NA,3,5,.600,.600,1,2,.500,0,2,2,1,0,0,1,2,7
Momar Ndoye,Senegal,3,28,0,3,.000,0,0,NA,0,3,.000,.000,1,2,.500,3,3,6,1,2,0,0,2,1
Mouhamed Hadidane,Tunisia,4,68,13,26,.500,5,10,.500,8,16,.500,.596,2,4,.500,2,10,12,3,0,1,2,4,33
Mouhammad Faye,Senegal,3,93,10,35,.286,5,22,.227,5,13,.385,.357,5,6,.833,2,9,11,6,4,1,5,8,30
Mourad El Mabrouk,Tunisia,4,105,9,30,.300,5,20,.250,4,10,.400,.383,0,0,NA,3,5,8,9,1,1,3,3,23
Mousa AL Awadi,Jordan,3,59,3,10,.300,2,6,.333,1,4,.250,.400,0,0,NA,1,5,6,5,2,0,6,3,8
Myles Turner,United States,3,63,6,17,.353,1,3,.333,5,14,.357,.382,5,7,.714,8,17,25,0,3,5,4,7,18
Nando De Colo,France,3,62,12,22,.545,4,8,.500,8,14,.571,.636,9,10,.900,1,1,2,13,2,0,7,5,37
Nathan Sobey,Australia,1,1,0,0,NA,0,0,NA,0,0,NA,NA,0,0,NA,0,0,0,0,0,0,0,0,0
Nemanja Bjelica,Serbia,3,61,15,26,.577,8,13,.615,7,13,.538,.731,5,5,1.000,7,9,16,13,2,1,3,4,43
Nemanja Radovic,Montenegro,2,16,2,5,.400,0,0,NA,2,5,.400,.400,0,0,NA,3,2,5,1,0,1,0,5,4
Nestor Colmenares,Venezuela,4,114,17,41,.415,2,7,.286,15,34,.441,.439,4,5,.800,14,14,28,10,7,1,6,11,40
Nicholas Kay,Australia,3,54,10,18,.556,1,1,1.000,9,17,.529,.583,6,6,1.000,3,6,9,4,0,0,2,1,27
Nick Calathes,Greece,3,80,14,32,.438,5,14,.357,9,18,.500,.516,2,5,.400,2,12,14,16,4,0,11,10,35
Nick Fazekas,Japan,3,74,13,24,.542,4,7,.571,9,17,.529,.625,1,4,.250,4,16,20,2,4,0,7,6,31
Nicolas Batum,France,2,49,3,10,.300,2,8,.250,1,2,.500,.400,0,0,NA,0,6,6,5,1,2,3,3,8
Nicolas Brussino,Argentina,4,55,6,14,.429,4,9,.444,2,5,.400,.571,0,0,NA,4,12,16,6,1,1,3,5,16
Nicolas Laprovittola,Argentina,4,85,12,35,.343,9,25,.360,3,10,.300,.471,8,10,.800,1,8,9,15,5,0,8,6,41
Niels Giffey,Germany,3,16,1,5,.200,0,1,.000,1,4,.250,.200,0,0,NA,1,0,1,1,0,0,2,3,2
Nikita Kurbanov,Russia,4,110,12,25,.480,2,6,.333,10,19,.526,.520,10,17,.588,5,18,23,16,2,1,7,14,36
Nikola Ivanovic,Montenegro,2,55,9,24,.375,3,14,.214,6,10,.600,.438,6,6,1.000,1,3,4,12,4,0,2,7,27
Nikola Jokic,Serbia,4,82,20,24,.833,4,5,.800,16,19,.842,.917,10,12,.833,5,23,28,18,0,3,13,9,54
Nikola Milutinov,Serbia,4,49,9,11,.818,0,0,NA,9,11,.818,.818,10,13,.769,1,5,6,2,1,1,1,2,28
Nikola Vucevic,Montenegro,3,63,14,29,.483,1,4,.250,13,25,.520,.500,6,8,.750,0,18,18,1,2,2,2,2,35
Nizar Knioua,Tunisia,3,38,3,7,.429,2,5,.400,1,2,.500,.571,0,0,NA,0,1,1,2,1,0,4,2,8
Noe-Charles Abouo,Ivory Coast,4,100,19,37,.514,6,13,.462,13,24,.542,.595,8,9,.889,3,8,11,5,3,0,6,6,52
Olek Balcerowski,Poland,4,47,5,11,.455,1,7,.143,4,4,1.000,.500,3,7,.429,2,6,8,1,1,0,1,6,14
Olimpio Cipriano,Angola,2,20,2,12,.167,0,7,.000,2,5,.400,.167,0,1,.000,0,0,0,1,1,0,1,1,4
Omar Abada,Tunisia,4,122,13,31,.419,4,12,.333,9,19,.474,.484,14,16,.875,2,9,11,18,11,0,5,6,44
Omar Mouhli,Tunisia,1,15,2,6,.333,1,4,.250,1,2,.500,.417,1,2,.500,0,0,0,1,1,0,1,0,6
Ondrej Balvin,Czech Republic,3,79,13,19,.684,0,0,NA,13,19,.684,.684,5,11,.455,6,21,27,5,1,6,6,9,31
Owen Klassen,Canada,3,35,1,6,.167,0,2,.000,1,4,.250,.167,6,8,.750,5,4,9,2,0,0,3,9,8
Panagiotis Vasilopoulos,Greece,2,14,0,1,.000,0,1,.000,0,0,NA,.000,0,0,NA,0,1,1,0,0,0,1,2,0
Pape Diop,Senegal,3,13,3,5,.600,0,1,.000,3,4,.750,.600,0,0,NA,1,2,3,0,1,0,0,3,6
Patricio Garino,Argentina,4,115,12,32,.375,4,12,.333,8,20,.400,.438,13,14,.929,4,13,17,5,9,4,3,9,41
Patrik Auda,Czech Republic,3,66,12,27,.444,1,3,.333,11,24,.458,.463,1,5,.200,5,10,15,3,1,0,1,9,26
Patty Mills,Australia,3,100,19,41,.463,6,19,.316,13,22,.591,.537,16,17,.941,0,4,4,9,3,0,7,3,60
Pau Ribas,Spain,4,67,7,17,.412,5,15,.333,2,2,1.000,.559,0,0,NA,0,6,6,6,3,0,1,3,19
Paul Biligha,Italy,4,72,8,15,.533,0,0,NA,8,15,.533,.533,1,2,.500,5,5,10,0,4,2,2,11,17
Paul Lacombe,France,2,27,3,5,.600,0,1,.000,3,4,.750,.600,0,0,NA,1,2,3,5,3,0,0,4,6
Paul Lee,Philippines,4,59,9,29,.310,2,17,.118,7,12,.583,.345,3,4,.750,2,1,3,2,2,0,1,6,23
Paul Zipser,Germany,3,65,6,17,.353,2,3,.667,4,14,.286,.412,4,4,1.000,2,10,12,2,3,1,1,6,18
Paulius Jankunas,Lithuania,3,27,3,11,.273,0,3,.000,3,8,.375,.273,7,8,.875,0,5,5,2,0,1,2,2,13
Pavel Pumprla,Czech Republic,3,43,4,10,.400,0,0,NA,4,10,.400,.400,3,9,.333,3,5,8,5,4,2,0,3,11
Pedro Chourio,Venezuela,4,49,9,19,.474,4,12,.333,5,7,.714,.579,0,0,NA,1,4,5,0,2,0,2,7,22
Petar Popovic,Montenegro,3,86,14,35,.400,4,12,.333,10,23,.435,.457,2,2,1.000,2,5,7,5,2,1,3,8,34
Philip Scrubb,Canada,3,61,6,19,.316,2,8,.250,4,11,.364,.368,2,2,1.000,0,8,8,5,0,0,2,4,16
Pierre Oriola,Spain,4,61,6,14,.429,0,5,.000,6,9,.667,.429,1,2,.500,7,9,16,0,0,0,0,5,13
Radhouane Slimane,Tunisia,3,23,2,8,.250,1,3,.333,1,5,.200,.313,0,0,NA,3,1,4,0,1,1,3,3,5
Rafa Luz,Brazil,3,69,7,15,.467,2,7,.286,5,8,.625,.533,5,5,1.000,2,6,8,13,4,0,6,11,21
Ramon Clemente,Puerto Rico,4,47,2,7,.286,1,5,.200,1,2,.500,.357,2,2,1.000,2,4,6,0,0,0,7,3,7
Rasoul Mozafarivanani,Iran,3,19,1,3,.333,1,2,.500,0,1,.000,.500,5,6,.833,1,1,2,3,1,0,3,0,8
Raymond Almazan,Philippines,4,24,1,4,.250,0,0,NA,1,4,.250,.250,0,0,NA,0,2,2,0,0,0,2,5,2
Reggie Moore,Angola,4,93,8,22,.364,7,15,.467,1,7,.143,.523,1,4,.250,2,12,14,5,1,0,4,8,24
Renaldas Seibutis,Lithuania,3,43,6,12,.500,1,2,.500,5,10,.500,.542,0,0,NA,0,2,2,2,0,0,0,6,13
Renaldo Balkman,Puerto Rico,4,108,11,35,.314,0,4,.000,11,31,.355,.314,9,11,.818,7,12,19,9,4,7,12,10,31
Ricky Rubio,Spain,4,95,17,40,.425,5,14,.357,12,26,.462,.488,15,19,.789,2,11,13,20,6,0,14,9,54
Rigoberto Mendoza,Dominican Republic,3,63,5,17,.294,2,6,.333,3,11,.273,.353,2,2,1.000,1,7,8,7,0,1,4,3,14
Rob Loe,New Zealand,3,82,8,20,.400,5,13,.385,3,7,.429,.525,5,10,.500,8,11,19,6,1,1,9,13,26
Robert Bolick,Philippines,4,53,9,23,.391,4,13,.308,5,10,.500,.478,6,6,1.000,3,1,4,5,0,0,6,2,28
Robin Benzing,Germany,3,53,4,18,.222,3,11,.273,1,7,.143,.306,6,6,1.000,3,6,9,3,0,1,1,3,17
Rokas Giedraitis,Lithuania,2,11,0,1,.000,0,1,.000,0,0,NA,.000,0,0,NA,0,1,1,1,0,0,0,0,0
Ronald Ramon,Dominican Republic,3,35,5,10,.500,3,6,.500,2,4,.500,.650,0,0,NA,0,0,0,4,1,0,1,6,13
Ronald Roberts,Dominican Republic,3,66,10,24,.417,0,0,NA,10,24,.417,.417,5,6,.833,8,8,16,1,2,0,1,8,25
RR Pogoy,Philippines,4,77,5,17,.294,2,10,.200,3,7,.429,.353,1,2,.500,2,6,8,4,2,0,3,9,13
Rudy Fernandez,Spain,4,97,8,23,.348,7,19,.368,1,4,.250,.500,3,4,.750,2,7,9,14,4,1,3,4,26
Rudy Gobert,France,3,72,13,18,.722,0,0,NA,13,18,.722,.722,12,15,.800,7,23,30,4,1,8,5,7,38
Rui Hachimura,Japan,3,90,13,30,.433,0,4,.000,13,26,.500,.433,14,20,.700,4,13,17,7,5,0,4,8,40
Rui Zhao,China,4,100,10,26,.385,3,13,.231,7,13,.538,.442,7,9,.778,1,5,6,5,3,0,4,11,30
Ryusei Shinoyama,Japan,3,53,4,8,.500,2,5,.400,2,3,.667,.625,0,0,NA,1,5,6,5,1,0,8,6,10
Sadiel Rojas,Dominican Republic,3,56,5,14,.357,1,4,.250,4,10,.400,.393,0,0,NA,5,6,11,2,3,0,5,10,11
Sajjad Mashayekhi,Iran,4,73,6,16,.375,1,3,.333,5,13,.385,.406,4,8,.500,4,8,12,1,3,0,7,14,17
Salah Mejri,Tunisia,4,120,25,47,.532,6,17,.353,19,30,.633,.596,7,8,.875,11,32,43,9,4,8,9,9,63
Samad Nik Bahrami,Iran,4,108,16,41,.390,9,18,.500,7,23,.304,.500,5,7,.714,2,10,12,10,1,1,8,9,46
Sangjae Kang,South Korea,4,27,3,5,.600,1,3,.333,2,2,1.000,.700,0,0,NA,1,5,6,0,0,0,2,2,7
Scottie Wilbekin,Turkey,2,36,6,13,.462,4,6,.667,2,7,.286,.615,1,1,1.000,0,4,4,6,0,0,2,8,17
Sead Sehovic,Montenegro,3,22,1,6,.167,0,1,.000,1,5,.200,.167,3,5,.600,1,2,3,0,1,0,2,2,5
Seiya Ando,Japan,1,17,0,4,.000,0,1,.000,0,3,.000,.000,0,0,NA,0,1,1,0,0,0,2,0,0
Semen Antonov,Russia,4,62,10,23,.435,0,7,.000,10,16,.625,.435,10,14,.714,6,13,19,5,2,2,4,4,30
Semih Erden,Turkey,3,68,6,14,.429,0,0,NA,6,14,.429,.429,4,7,.571,4,11,15,2,3,1,5,13,16
Seounghyun Lee,South Korea,4,127,15,35,.429,5,15,.333,10,20,.500,.500,3,4,.750,5,15,20,6,1,2,9,7,38
Sergey Karasev,Russia,4,63,5,14,.357,3,8,.375,2,6,.333,.464,7,9,.778,0,5,5,6,4,0,5,7,20
Sergio Llull,Spain,4,84,14,38,.368,6,23,.261,8,15,.533,.447,5,6,.833,0,5,5,14,3,0,9,9,39
Sertac Sanli,Turkey,3,38,4,7,.571,0,0,NA,4,7,.571,.571,4,8,.500,0,7,7,0,2,0,2,8,12
Shea Ili,New Zealand,3,67,8,17,.471,1,3,.333,7,14,.500,.500,18,22,.818,2,8,10,21,3,3,4,10,35
Shuo Fang,China,4,71,7,24,.292,3,17,.176,4,7,.571,.354,3,3,1.000,0,3,3,5,3,0,3,10,20
Shuto Ando,Japan,2,14,0,6,.000,0,6,.000,0,0,NA,.000,0,0,NA,1,1,2,0,0,0,2,0,0
Souleyman Diabate,Ivory Coast,4,103,12,37,.324,6,15,.400,6,22,.273,.405,0,0,NA,1,2,3,17,4,0,8,4,30
Stanley Okoye,Nigeria,4,49,7,14,.500,7,9,.778,0,5,.000,.750,1,2,.500,1,6,7,8,2,1,1,5,22
Stefan Bircevic,Serbia,4,47,9,18,.500,4,11,.364,5,7,.714,.611,3,6,.500,1,13,14,3,3,1,1,7,25
Stefan Jovic,Serbia,4,81,10,20,.500,3,8,.375,7,12,.583,.575,1,2,.500,3,14,17,25,4,0,7,6,24
Suad Sehovic,Montenegro,3,71,3,11,.273,3,10,.300,0,1,.000,.409,3,3,1.000,1,7,8,2,0,0,2,6,12
Sun Minghui,China,3,32,3,11,.273,1,6,.167,2,5,.400,.318,1,3,.333,2,2,4,2,2,0,0,5,8
Sunhyung Kim,South Korea,4,100,9,41,.220,2,15,.133,7,26,.269,.244,7,9,.778,5,7,12,15,3,0,4,5,27
Tai Webster,New Zealand,3,77,14,34,.412,2,12,.167,12,22,.545,.441,10,14,.714,1,13,14,12,2,0,12,12,40
Talib Zanna,Nigeria,3,28,2,8,.250,1,2,.500,1,6,.167,.313,2,4,.500,3,5,8,4,2,1,3,3,7
Tayavek Gallizzi,Argentina,2,15,1,5,.200,0,0,NA,1,5,.200,.200,4,4,1.000,2,2,4,0,3,1,1,6,6
Thanasis Antetokounmpo,Greece,3,36,7,13,.538,2,5,.400,5,8,.625,.615,2,4,.500,2,2,4,3,2,2,3,9,18
Thomas Abercrombie,New Zealand,3,84,9,25,.360,4,12,.333,5,13,.385,.440,5,7,.714,4,14,18,1,3,2,2,9,27
Thomas Scrubb,Canada,3,29,3,6,.500,2,2,1.000,1,4,.250,.667,3,5,.600,2,1,3,3,0,0,1,6,11
Tiegbe Bamba,Ivory Coast,4,69,8,17,.471,4,8,.500,4,9,.444,.588,5,9,.556,3,3,6,2,1,0,4,8,25
Tohi Smith-Milner,New Zealand,3,38,3,8,.375,2,5,.400,1,3,.333,.500,1,2,.500,2,1,3,1,4,3,0,4,9
Tomas Satoransky,Czech Republic,3,100,13,34,.382,3,8,.375,10,26,.385,.426,14,16,.875,2,13,15,19,3,0,7,7,43
Tomas Vyoral,Czech Republic,1,2,0,0,NA,0,0,NA,0,0,NA,NA,0,0,NA,0,0,0,0,0,0,0,0,0
Troy Rosario,Philippines,4,79,5,17,.294,1,7,.143,4,10,.400,.324,1,2,.500,8,12,20,1,0,0,2,9,12
Vafessa Fofana,Ivory Coast,4,85,3,17,.176,1,8,.125,2,9,.222,.206,4,6,.667,1,5,6,11,5,2,17,9,11
Vander Joaquim,Angola,4,86,15,29,.517,3,6,.500,12,23,.522,.569,9,12,.750,5,13,18,1,4,4,8,13,42
Vangelis Mantzaris,Greece,1,10,0,0,NA,0,0,NA,0,0,NA,NA,2,2,1.000,0,2,2,5,0,0,0,0,2
Vasilije Micic,Serbia,4,81,10,15,.667,1,3,.333,9,12,.750,.700,4,4,1.000,1,4,5,21,6,0,8,9,25
Victor Claver,Spain,4,95,15,28,.536,5,12,.417,10,16,.625,.625,2,3,.667,9,11,20,7,3,2,5,9,37
Victor Liz,Dominican Republic,3,78,14,30,.467,6,14,.429,8,16,.500,.567,10,12,.833,3,6,9,6,3,1,14,3,44
Vincent Poirier,France,3,51,7,11,.636,0,0,NA,7,11,.636,.636,8,9,.889,6,11,17,3,1,0,5,4,22
Vitaly Fridzon,Russia,4,93,13,30,.433,3,10,.300,10,20,.500,.483,4,7,.571,4,7,11,9,8,0,5,10,33
Vitor Benite,Brazil,3,47,4,19,.211,4,11,.364,0,8,.000,.316,3,5,.600,0,3,3,1,1,0,2,8,15
Vladimir Ivlev,Russia,4,52,7,10,.700,1,1,1.000,6,9,.667,.750,1,2,.500,3,7,10,1,3,0,1,11,16
Vladimir Lucic,Serbia,4,84,6,11,.545,0,3,.000,6,8,.750,.545,5,5,1.000,2,11,13,3,3,0,1,10,17
Vojtech Hruban,Czech Republic,3,87,16,32,.500,3,13,.231,13,19,.684,.547,2,2,1.000,2,5,7,7,1,1,5,8,37
Windi Graterol,Venezuela,4,34,3,9,.333,0,2,.000,3,7,.429,.333,0,0,NA,9,6,15,2,0,1,1,8,6
Xane D'Almeida,Senegal,3,89,8,22,.364,3,11,.273,5,11,.455,.432,2,3,.667,1,7,8,14,2,1,4,6,21
Xavi Rabaseda,Spain,2,14,0,1,.000,0,1,.000,0,0,NA,.000,0,0,NA,1,0,1,2,1,0,3,2,0
Xiaochuan Di,China,4,86,12,17,.706,0,2,.000,12,15,.800,.706,2,3,.667,5,8,13,1,3,1,3,7,26
Yago Mateus Dos Santos,Brazil,1,6,1,3,.333,0,1,.000,1,2,.500,.333,1,1,1.000,0,0,0,0,0,0,1,1,3
Yanick Moreira,Angola,4,109,18,38,.474,0,0,NA,18,38,.474,.474,3,6,.500,13,21,34,2,3,1,5,14,39
Ioannis Bourousis,Greece,3,45,6,13,.462,3,7,.429,3,6,.500,.577,4,4,1.000,1,9,10,3,2,0,4,5,19
Yigit Arslan,Turkey,1,2,0,1,.000,0,1,.000,0,0,NA,.000,0,0,NA,1,1,2,1,0,0,0,0,0
Yousef Abuwazaneh,Jordan,3,10,0,1,.000,0,0,NA,0,1,.000,.000,0,0,NA,1,0,1,1,0,0,1,0,0
Youssou Ndoye,Senegal,3,73,10,26,.385,0,4,.000,10,22,.455,.385,6,8,.750,6,11,17,2,2,2,5,7,26
Yudai Baba,Japan,3,78,10,25,.400,2,6,.333,8,19,.421,.440,4,6,.667,0,7,7,8,4,0,4,5,26
Yuta Watanabe,Japan,3,91,13,30,.433,1,6,.167,12,24,.500,.450,8,10,.800,2,11,13,5,2,1,2,4,35
Zaid Abbas,Jordan,3,78,7,25,.280,1,6,.167,6,19,.316,.300,1,5,.200,9,7,16,7,1,0,11,12,16
Zhao Jiwei,China,4,111,6,19,.316,4,12,.333,2,7,.286,.421,7,8,.875,0,8,8,14,6,0,2,6,23
Zhelin Wang,China,4,76,10,22,.455,0,0,NA,10,22,.455,.455,8,11,.727,6,12,18,1,3,1,3,14,28
Zhou Qi,China,4,118,17,31,.548,3,9,.333,14,22,.636,.597,6,15,.400,6,28,34,5,4,7,7,11,43
Ziyed Chennoufi,Tunisia,4,49,2,11,.182,1,4,.250,1,7,.143,.227,1,2,.500,2,0,2,2,2,0,2,7,6
